推數,噓數,文章分數,文章作者,文章名稱,發表時間
25,4,21,Rusnake5566 (魯蛇+56 PTT最強帳號),[問卦] 兩個候選人選前一個月同時陣亡的可能性,Fri Oct  2 13:56:39 2020
11,11,0,LoveMakeLove (ボケ),[新聞]江啟臣：兩岸是不對稱的戰爭 從募兵改徵兵,Wed Oct  7 18:53:08 2020
20,0,20,MintSu (Simon),[問卦] 如果川普老婆死於武漢肺炎會怎麼樣？,Fri Oct  2 13:30:55 2020
31,2,29,seiya2000 (風見),[問卦] 為什麼古代生物體型可以長到這麼大？,Fri Oct  2 12:35:18 2020
106,6,100,kasumi5566 (霞),[問卦] 支那女生是不是都沒錢修補衣服,Fri Oct  2 13:43:25 2020
11,27,-16,starport (輕鬆看),[新聞] 川普夫婦確診了！網友卻認為「案情不單,Fri Oct  2 14:30:34 2020
6,0,6,trolleybus99 (不要問),[問卦] 習大大現在在想什麼,Fri Oct  2 14:07:53 2020
2,4,-2,hk410050 (A柏),[新聞] 國際藝文人士來台可申請專案縮短隔離 國,Wed Oct  7 16:53:31 2020
36,4,32,tennoji2003 (),[問卦] 隨便說三個你會的做愛技巧！,Wed Oct  7 17:55:20 2020
4,0,4,XDDDpupu5566 (XDpu56家族),[問卦] 亡國之君在想什麼？,Fri Oct  2 14:13:42 2020
4,3,1,E24056823 (RAINFAULT),[問卦] 現在新聞都喜歡用什麼字眼啊,Fri Oct  2 13:25:47 2020
7,2,5,hhuuu (hhhh),[問卦] 你第一眼直覺這個能防螞蟻嗎,Wed Oct  7 17:30:27 2020
149,14,135,gogopacer (gogopacer),[問卦] 大安區的便當這樣多少？,Wed Oct  7 18:07:59 2020
2,2,0,WaWa3 (寂寞的麻糬),[問卦] 泌尿科找女醫師，最後向台女露鳥的機會？,Fri Oct  2 11:32:58 2020
10,0,10,ccf52881 (ccf52881),[新聞] 新莊、樹林周邊電桿全面地下化 耗資9億54,Wed Oct  7 16:42:00 2020
4,0,4,zalora (lara),[新聞] 印度邊境布防巡航導彈目標鎖解放軍西藏,Fri Oct  2 12:59:39 2020
94,29,65,www90173 (明鏡),[問卦] 華堡是不是屌打大麥克,Wed Oct  7 16:26:18 2020
8,6,2,cimo764 (蘋果西打),[新聞] 扯！台中發獎狀竟印中國民國　師：原來,Wed Oct  7 19:37:02 2020
4,0,4,a12345x (到不了終點),[問卦] 台灣的印度人多嗎,Fri Oct  2 12:49:40 2020
56,2,54,Conan5566 (連續殺人),[問卦] 川普遺書會寫什麼？,Fri Oct  2 15:01:05 2020
2,6,-4,posen2012 (posen),[問卦] 阿福一字馬484很香啊？,Wed Oct  7 17:20:27 2020
8,2,6,ericf129 (☆小艾克★),[問卦] 有沒有國慶煙火超屌的八卦？,Wed Oct  7 16:13:15 2020
8,10,-2,keane9112 (拎北逮頑郎 拎北反支那啦),[問卦] 那些質疑魏如萱的是否沒看到這段才質疑,Wed Oct  7 16:47:45 2020
4,0,4,aure0914 (tunik),[問卦] 如果川普在選前掛掉會怎樣？,Fri Oct  2 14:46:55 2020
10,0,10,cklovework (ckcck休。),[問卦] 65歲老人可以湊到一個輕裝師嗎？,Wed Oct  7 19:56:55 2020
5,0,5,sookie (宣醬),[新聞] 最新Chromecast搭載Google TV與遙控器,Wed Oct  7 19:05:05 2020
9,1,8,faceloser (臉輸哥),[問卦] 如果川普跟拜登都在選前病逝？,Fri Oct  2 13:29:51 2020
2,2,0,jiouje (JioUje),[問卦] 洗頭妹 幫我洗頭帶手套？？？？,Wed Oct  7 21:20:19 2020
11,3,8,jerrysuper (super),[問卦] 機車吵爸媽出錢買的在想什麼？,Fri Oct  2 12:45:31 2020
26,3,23,jasonlin2100 (jasonlin),[問卦] 湖口一堆流氓8+9？,Wed Oct  7 18:39:50 2020
11,3,8,abcde010710 (跟著風向走的肥宅),[問卦] 林俊傑音樂功力怎麼樣,Wed Oct  7 17:16:44 2020
4,0,4,hmt17 (Popo:(bﾟ▽ﾟ)b),[新聞]《惡靈古堡》電影再啟卡司曝光！Netfix影,Wed Oct  7 21:20:51 2020
30,1,29,wizardfizban (瘋法師),[新聞] 萊豬文宣竟進入北市7國小 北市教育局：確,Wed Oct  7 20:41:42 2020
12,0,12,ibox5566 (I盒子5566),[問卦] 今天美股會熔斷嗎？,Fri Oct  2 13:09:18 2020
12,4,8,ron19971997 (安安),[問卦] 台北車站真的算迷宮嗎？,Wed Oct  7 16:47:55 2020
1,3,-2,powyo (光子郎),[問卦] 排骨酥湯+湯圓 這樣吃會很客家嗎,Fri Oct  2 13:12:15 2020
32,7,25,tw689 (台灣689),[問卦] 住在陽明山上有什麼優點？,Wed Oct  7 20:16:57 2020
6,2,4,stock5566 (股神56),[問卦] 活過2020年484能嘴一輩子？,Fri Oct  2 13:33:39 2020
1,0,1,showlive0214 (凡艾草),[問卦] 川普確診是不是八奇的思考力領域,Fri Oct  2 14:17:26 2020
9,1,8,underwood (安德伍德),[問卦] 有人只能靠年終存錢的ㄇ,Fri Oct  2 12:11:08 2020
1,0,1,aabbcc520 (U質文),[問卦] 請問女同事問我要不要去同事婚禮的八卦,Fri Oct  2 14:57:45 2020
6,3,3,nissan168 (pingGO),[問卦] 坑殺四十萬趙國降卒？,Fri Oct  2 12:47:02 2020
9,2,7,lotudi (憶苦方知思甜),[問卦]低碳飲食的狀態下有辦法不容易肚子餓？,Wed Oct  7 17:54:03 2020
10,0,10,LeonardoChen (LeonardoChen),[問卦] 亂倫的黑數484很高？,Wed Oct  7 16:35:19 2020
0,0,0,zzyyxx77 (討噓大師77),[問卦] 騎到新竹宇老 再來要幹嗎？,Fri Oct  2 15:37:17 2020
117,15,102,Quiff (in the Shell),[爆卦] 拜登領先擴大至21%！,Wed Oct  7 17:52:26 2020
1,0,1,tangqingcai (燙青菜),[問卦] 武漢病毒現在在想什麼？,Fri Oct  2 13:21:56 2020
25,6,19,Allen1096 (慾望越大，硬碟越大),[問卦] 有沒有新竹火車站的八卦,Wed Oct  7 18:30:59 2020
12,14,-2,Mayinggo (甲甲跟柯糞一起下去),[新聞] 變態直排輪教練！帶7男童拍裸照打飛機,Fri Oct  2 12:29:23 2020
5,13,-8,nk11208z (小魯),[新聞] 戰爭時誰收屍？PTT鄉民揭神秘內幕：大賺,Fri Oct  2 12:02:20 2020
3,4,-1,Holmes7 (El Mundo),[問卦] 我哥也是勞工為何不嫌退休金少？,Wed Oct  7 19:18:30 2020
5,2,3,saisai9230 (小為),[新聞] 延攬柯文哲人馬 林右昌證實前北市府發言人林昆鋒接綜合發展處長,Wed Oct  7 20:14:42 2020
30,5,25,Usayhiisayha (【〖《〔（{`}）〕》〗】),[問卦] 海陸全餐加蔥蛋林志玲吃的完嗎？,Fri Oct  2 11:53:04 2020
5,0,5,sam197665 (東哥),[問卦] 川普對上羅禮士，誰會贏？,Wed Oct  7 20:39:58 2020
27,3,24,badjye911 (阿三),[問卦] 基隆以後適合長住嗎？,Fri Oct  2 11:50:33 2020
8,2,6,perfidia (Schlafmütze),[問卦] FB上面放BMW跟放MBL哪個可以吸引到女森？,Wed Oct  7 17:40:13 2020
5,2,3,mesubutaMYS (YBUTACHAN),[問卦] 上帝連我的隊友都救不了，如何救世人,Fri Oct  2 13:55:12 2020
5,6,-1,kashima228 (承),[問卦] 機車上高速到底有沒有合法？,Wed Oct  7 18:51:23 2020
72,7,65,faosxh (灰狐狸),[問卦] 有沒有像「北榮」這種簡稱的簡稱,Fri Oct  2 14:25:18 2020
0,2,-2,d995511 (flcl),[問卦] 買惹many發現路上妹子都在看我怎麼辦？,Wed Oct  7 21:23:36 2020
6,0,6,HyperPoro (TomorrowIsInYourHands),[問卦] 川普如果癒後颯爽復出會發生什麼事？,Fri Oct  2 14:44:17 2020
5,0,5,opfish (coco),[問卦] 爐渣市要辦國慶煙火有推薦好玩好吃的嗎,Fri Oct  2 12:58:01 2020
129,21,108,facebookig (魯蛇臉書),[爆卦] 恭喜警察被記申誡喔！,Wed Oct  7 19:41:08 2020
40,5,35,lockgolden (鎖金),[問卦] 有匿蹤戰機，怎麼匿蹤飛彈還沒做出來？,Wed Oct  7 17:10:45 2020
6,3,3,Francise (少喝飲料多喝水),[問卦] 雙北的8＋9都藏在哪？,Wed Oct  7 18:46:36 2020
4,1,3,s110269 (),[問卦] 放假前進十張2330是不是躺著數錢？,Fri Oct  2 13:41:38 2020
3,0,3,"sheep531531 (只是一隻羊 @(""o_o"")@)",[問卦] 甘草粉是不是屌打梅粉？,Wed Oct  7 18:49:36 2020
30,2,28,amoebaba719 (阿米巴(按z進精華區)),[新聞] Subway潛艇堡的麵包不是麵包？愛爾蘭法院,Wed Oct  7 18:20:29 2020
7,0,7,LaAc (深淵戰士),[問卦] 有沒有hspice的八卦,Wed Oct  7 20:08:51 2020
8,4,4,r1i545we (種田賣菜郎),[問卦] 看到教召要加薪教召仔有多爽？？,Wed Oct  7 20:13:57 2020
23,2,21,Stella289 (Stella),[新聞] 放寬除役年限？年齡擬提高到50歲,Wed Oct  7 20:49:37 2020
62,74,-12,googolplex (googolplex),[爆卦] 最新防疫成功國家排名 中國第一 台灣榜外,Wed Oct  7 17:40:29 2020
8,0,8,IslamicState (伊斯蘭國-不亂砍頭),[問卦] 川普中標會讓美國選舉產生變數嗎,Fri Oct  2 13:08:07 2020
1,1,0,bluebagel (果果:)),[問卦] 大家幾天沒洗頭會變條碼頭？,Fri Oct  2 13:28:29 2020
13,7,6,Sandra777 (珊朵拉),[問卦] 年薪40萬  可以買台北哪裡？,Wed Oct  7 18:00:37 2020
19,1,18,theskyofblue (天空藍),[問卦] 蘋果的safari為啥這麼多人愛用,Fri Oct  2 15:18:20 2020
5,0,5,matatabi (matatabi),[問卦] 台中火車站那麼多家太陽餅都誰在買的？,Wed Oct  7 18:29:46 2020
3,1,2,Giddcns (狠、插、勁！！！),[問卦] 有沒有蓋牌的八卦？,Wed Oct  7 16:30:55 2020
6,3,3,DavidGuetta (大衛 庫塔),[問卦] 台灣跟中國一樣虛坪制不丟臉嗎？,Wed Oct  7 16:58:55 2020
10,5,5,stockeye (stockeye),[新聞] 救豬農「百億基金」首曝光 陳吉仲：4年共,Wed Oct  7 21:00:08 2020
23,3,20,mucorn (MU),[問卦] 美國總統中毒，最爽的是誰？,Fri Oct  2 13:17:51 2020
8,5,3,soulboy330 (stay the course),[問卦] 咖啡因洗髮精真的有用嗎？,Wed Oct  7 19:36:34 2020
1,0,1,ASKR (ASKR),[問卦] 阿薩斯會淨化白宮嗎,Fri Oct  2 13:27:28 2020
4,1,3,tigotigo5566 (鐵劍5566),[問卦] 有沒有黃安又要拍戲的八卦？,Fri Oct  2 14:35:56 2020
33,3,30,fenway18 (天然本草),[新聞] 慕尼黑房市 泡沫風險冠全球,Wed Oct  7 19:45:27 2020
4,1,3,d995511 (flcl),[問卦] 明天要挑戰一人頂三工好緊張？,Wed Oct  7 20:53:21 2020
5,0,5,christiano (喀稱),[問卦] 外國人中文歌的例子多嗎？,Wed Oct  7 16:35:27 2020
1,2,-1,hydroer (水人),[問卦] 汪建民和丸子的Junior要怎麼分？,Wed Oct  7 20:10:35 2020
3,0,3,jun059 (好想睡覺),[問卦] 想見你為啥沒入圍金曲獎？,Wed Oct  7 21:15:44 2020
40,0,40,jackliao1990 (jack),[爆卦] 2020年諾貝爾化學獎,Wed Oct  7 17:48:42 2020
6,1,5,stuj9019 (肥宅好吃 ^Q^),[問卦] 該怎麼用北京話求饒,Fri Oct  2 13:18:06 2020
94,13,81,chee77724 (打工小天后),[新聞] 大安警衛伴李登輝36年今解散歸建 　李坤,Wed Oct  7 17:16:21 2020
26,7,19,milkBK (blitzkrieg比較低),[問卦] 台灣有厲害的科普YT嗎？,Fri Oct  2 12:09:51 2020
2,1,1,ht91008 (色情狂),[問卦] 在美國生病只能自身自滅嗎？,Fri Oct  2 14:49:39 2020
5,22,-17,GOD5566GOD (o'_'o),[問卦] 覺青是不是嚇得屁滾尿流了wwwwwww,Fri Oct  2 14:06:27 2020
4,2,2,Dodoroiscute (再想想),[問卦] 美豬進口台灣，誰會去代理經銷啊？,Wed Oct  7 18:44:33 2020
16,2,14,goldenhill (我的人權時代),[新聞]「退黨證書」可線上辦 中國人紛退黨自保,Wed Oct  7 20:13:46 2020
25,7,18,sec5566 (sec),[問卦] 象棋是不是不懂戰爭的人發明的,Wed Oct  7 19:33:26 2020
13,5,8,qk56 (休息56),欸! 教召爭議其實是因為不公平吧!,Wed Oct  7 18:00:15 2020
7,2,5,shoga (歡迎 來自星星的Elohim),[爆卦] 日本藝人結婚對東京股市的衝擊,Fri Oct  2 14:50:45 2020
8,0,8,sodistrues (true),[問卦] 為什麼日本AKB會突然力捧大盛真步？,Fri Oct  2 12:21:16 2020
131,14,117,scum5566 (你好宅),[新聞] 礦業63歲老闆再婚娶38歲妻 新娘：嫁給愛,Wed Oct  7 17:06:14 2020
30,5,25,zxc2331189 (阿拉花瓜),[新聞] 獨／國道又見機車趴趴走…連過2交流道不,Wed Oct  7 16:38:34 2020
25,6,19,fnm525 (22/7博士後研究員),[問卦] 大學私立前段是哪幾間阿？,Wed Oct  7 18:34:51 2020
7,2,5,edwardsyo (愛德華),[問卦] 中秋節大家會做愛吧,Fri Oct  2 14:06:43 2020
14,1,13,arrenwu (拉姆真可愛),[問卦] 為什麼兔田佩可拉一直在用小畫家？,Wed Oct  7 19:59:29 2020
11,88,-77,nerudaliu (Chairborne Ranger),[新聞] 「不管你說什麼，我反戰！」龍應台怒批,Wed Oct  7 17:53:46 2020
16,1,15,Masahiro (),[新聞] 超愛吃肉乾！28歲女罹大腸癌　醫曝研究,Fri Oct  2 12:29:44 2020
4,5,-1,Taiwanese (臺灣人),[問卦] 年收50萬在鄉下地方是什麼等級,Fri Oct  2 13:43:02 2020
5,2,3,edrpj (非賣品),[新聞] 網購3盒壯陽藥 男子差點被關10年,Wed Oct  7 18:52:23 2020
18,2,16,thomasyu (你要戰，便來戰),[新聞] 19歲男大生多次與15歲女孩上床　品行優良,Wed Oct  7 16:45:50 2020
9,4,5,mickeykiller (黑色曼陀羅),[問卦] 市容差距,Wed Oct  7 16:15:35 2020
7,7,0,kukulee (),[新聞] 辦好市多會員卡值得？過來人曝「真實經驗,Fri Oct  2 11:31:35 2020
8,2,6,cosmite (焼き団子),[問卦] 娶到銀行員是什麼感覺？,Wed Oct  7 19:31:51 2020
7,1,6,tLuesuGi (不識庵謙信),[問卦] 所以推背圖有推到川普陽性嗎,Fri Oct  2 14:18:11 2020
13,0,13,laptic (靜夜聖林彼岸花),[新聞] 夫妻冷戰10年互罵畜生、惡毒的嘴 法院認2人已恩斷義絕,Fri Oct  2 14:45:01 2020
17,7,10,wuyiulin (機掰客家人),[問卦] 撿到鴿子怎麼辦？,Wed Oct  7 19:04:47 2020
7,3,4,ClownT (克朗),[問卦] 愛莉莎莎算是PTT反串的巔峰嗎？,Fri Oct  2 12:45:48 2020
65,3,62,despairF (オタクペンギン),[問卦] 有沒有四級地震的卦？,Wed Oct  7 19:20:23 2020
2,0,2,pkmu8426 (巴426),[新聞] 開放美豬｜農委會疑濫用政策行銷費用,Wed Oct  7 17:45:25 2020
6,2,4,jt1801 (白白的),[問卦] 閩南民系漢族的特徵是什麼？,Fri Oct  2 14:38:28 2020
21,5,16,tn00270144 (正義),[問卦] 為什麼我還沒被教召過？？？,Wed Oct  7 20:38:18 2020
0,0,0,qazwsx0128 (*****),[問卦] 美國之子捨身對抗邪惡這劇本怎麼樣,Fri Oct  2 13:54:04 2020
6,0,6,lauwei (lauwei),[問卦] 拜登如果輸了會提起選舉無效之訴嗎,Fri Oct  2 13:27:14 2020
37,19,18,Stella289 (Stella),[問卦] 除役年齡 可能要延長14年了,Wed Oct  7 19:01:53 2020
2,0,2,Flitz (費爾),[問卦] 台灣以外的中秋節 有人在烤肉嗎,Fri Oct  2 13:46:54 2020
26,1,25,dream0821 (早餐很重要),[問卦] 習近平怎摸都沒事啊,Fri Oct  2 14:14:19 2020
41,18,23,shiwenli (別哭),[新聞] 機車族不是人！ 中央擬取消人行道機車格,Fri Oct  2 15:23:54 2020
14,3,11,OhwadaAkira (大和田常務),[新聞] 駁陳廷寵 嚴德發：國軍現在最有戰力,Wed Oct  7 17:19:57 2020
11,1,10,jack3254 (cozoro),[問卦] 簡廷芮男友是不是很有錢？,Fri Oct  2 13:58:11 2020
18,1,17,zft777 (誰贊成?誰反對?),[問卦] 百度鎖臺灣ip是不是分裂國家？,Wed Oct  7 18:10:09 2020
0,0,0,Killhugh (),[問卦]  A date which will live in infamy,Fri Oct  2 13:42:20 2020
2,0,2,DONNY (Donny),[問卦] 有沒有給我tempo ready go 的掛,Fri Oct  2 12:13:38 2020
10,4,6,bamama56 (bamama),[新聞] 3000違建工廠僅300納管　桃園祭違建剋星,Fri Oct  2 12:23:05 2020
1,0,1,Phoenix723 (操場旁的含羞草),[問卦] 辛普森家庭的製作人？,Fri Oct  2 15:17:05 2020
3,1,2,kone33221 (阿揪),[問卦] 有沒有智力測驗的八卦？,Wed Oct  7 16:25:00 2020
4,0,4,YU0121 (愛玉冰™),[問卦] 朋友去買豪宅,Fri Oct  2 11:54:47 2020
19,2,17,royroy666 (老鼠),[問卦] 要世界大戰了嗎？,Fri Oct  2 13:12:52 2020
7,0,7,lupin2401 (信長肛森蘭),[問卦] 川普確診的時間點,Fri Oct  2 15:13:34 2020
2,0,2,shala (沙羅是轉換後的文字檔打m),[問卦] 開戰後要打多久才能讓共匪喪失戰意？,Wed Oct  7 21:03:18 2020
5,15,-10,chadmu (查德姆),[新聞] 爆哭！吳宗憲現場骰子擲到這一面「小鬼真,Wed Oct  7 20:04:13 2020
0,0,0,HIDEI524 (shuchan),[問卦] 辯論會的辯論人位置是社交距離嗎？,Fri Oct  2 14:34:11 2020
1,0,1,iwannashot (奶油會飛),[問卦] 翻墮羅拳接班人,Fri Oct  2 13:47:33 2020
52,4,48,peterlin495 (專業果粉O'_'O),[新聞] 習近平思想 納入中國重點大學必修課,Wed Oct  7 20:54:10 2020
6,0,6,iamshiba ((  ・ω・`),[問卦] 有湯瑪士小火車真人版的卦ㄇ,Wed Oct  7 18:21:58 2020
8,0,8,ich2 (北川石原都是我老婆),[問卦] 台北人連假會去哪裡玩的八卦,Fri Oct  2 14:09:00 2020
11,0,11,fawangching (陽光宅叔),[問卦] 中國484完了,Fri Oct  2 13:37:19 2020
168,1,167,zxc8899546 (183帥哥),[協尋] 桃園交通事故，請大家幫幫忙,Mon Oct  5 18:38:57 2020
1,5,-4,astring (AString),[問卦] 大蛇丸是不是也得肺炎？,Fri Oct  2 14:36:16 2020
216,33,183,richjf (richArt),[新聞] 何志偉提美豬總量管制 蔡英文不語、中常,Wed Oct  7 17:53:49 2020
1,2,-1,s910211 (我愛PTT),[問卦] 發現自己對別人的悲慘無感，怎麼釋懷？,Wed Oct  7 18:22:07 2020
11,2,9,e22103 (RRRRRRRRRRRRRRRRRRRR),[新聞] 林智堅表態不選新北市長 侯友宜：好人才,Fri Oct  2 15:08:18 2020
6,2,4,relax911 (Lmerro),[新聞] 營養午餐文宣遭疑宣揚瘦肉精 教育部要求,Wed Oct  7 17:48:48 2020
6,1,5,deurpye (WORRY),[問卦] 潘瑋柏 瘦子Ozi,Wed Oct  7 20:46:52 2020
12,1,11,ibox5566 (I盒子5566),[問卦] 禮拜一台股開盤要馬上把股票賣掉嗎？,Fri Oct  2 13:28:28 2020
6,4,2,kuro (垃圾不分藍綠),[新聞] 台灣大道違停昨害死18歲女大生　扯！貨車,Wed Oct  7 21:10:17 2020
0,0,0,nanami56 (I 佛 U),[問卦] 欸幾年沒放過颱風假了？,Wed Oct  7 20:21:01 2020
317,26,291,rpg1510 (八分之三),[新聞] 國民黨推台美復交…國台辦崩潰了 江啟臣,Wed Oct  7 17:58:48 2020
1,0,1,colorless (colorless),[新聞] 美50名參議員致函川普政府 敦促展開台美BTA談判,Fri Oct  2 14:31:15 2020
0,0,0,longtimens (阿捲),[問卦] 是不是有重大事件就是ptt的價值發揮的時,Fri Oct  2 13:35:39 2020
3,2,1,ai770116 (東方的神秘力量),[問卦] 有沒有川普都不戴口罩很沒水準的八卦,Fri Oct  2 13:23:28 2020
4,1,3,JKGOOD (Dont QQ),[問卦] 為什麼有錢人愛打高爾夫,Fri Oct  2 11:54:27 2020
4,18,-14,duncan8522 (小B),[新聞] 內衣女模遭硬塞　胸部驚見「異物」！闆娘,Wed Oct  7 18:14:20 2020
8,2,6,wangyc (粒咲杏子的老公),[問卦] 有沒有一姆三分咪的八卦？,Fri Oct  2 13:53:12 2020
12,8,4,samgreco (55),[問卦] 台灣人為什麼排斥當兵上戰場呢？,Fri Oct  2 14:00:25 2020
4,1,3,YU0121 (愛玉冰™),[問卦] 商圈一堆女性品牌服飾到底誰在買的？,Wed Oct  7 16:46:47 2020
25,4,21,owo0204 (owo0204),[問卦] 美國總統死於武漢肺炎的話這仇多大,Fri Oct  2 15:28:46 2020
6,1,5,silentknight (清純男),[問卦] 為什麼白石麻衣的影片出現的是白石茉莉奈,Wed Oct  7 18:55:21 2020
453,34,419,rabbit83035 (遠野妖怪前綫),[新聞] 獨家》教室冷氣跳電停機一個月 高市國小,Wed Oct  7 18:24:04 2020
52,12,40,Ryo5566 (),[新聞] 國小菜單驚見瘦肉精文宣挨轟　北市教育,Wed Oct  7 19:11:57 2020
7,3,4,Jyery (文弟),[問卦] 慟！Fighter 6停產了,Wed Oct  7 16:45:50 2020
7,3,4,pulagu (遠離中共，遠離瘟疫！),[新聞] 確診者在身邊？ 新APP將發出警告,Fri Oct  2 14:12:07 2020
9,1,8,rfvujm (Rfvujm),[問卦] 現在沒人在說很台了嗎,Wed Oct  7 20:23:40 2020
20,6,14,HTC92 (中国台湾人的驕傲-92共識),[新聞] 高雄全套店收三倍券 更自製「振興折200券,Wed Oct  7 18:47:54 2020
20,2,18,PrinceKanto (生田絵梨花は俺の嫁),[新聞] 川普夫婦確診新冠肺炎 副總統潘斯：為他,Fri Oct  2 15:21:02 2020
5,15,-10,XXXXCOW (xxxxcow),[新聞] 拍妻絲襪辣腿…遭轟死變態！尪1句反擊 冉,Wed Oct  7 19:03:46 2020
32,2,30,oz5566 (威廉。霍恩索倫),[問卦] 拜登應該嚇死了吧,Fri Oct  2 14:08:09 2020
5,0,5,reppoc (稍會),[問卦] 川普推特宣布中標前會先操作股票嗎？,Fri Oct  2 14:31:43 2020
20,7,13,ubcs (覺★青年超冒險蓋),[公告] 多篇無關推噓文 水桶,Wed Oct  7 17:49:04 2020
11,1,10,EvilisGood (Hustler),[問卦] 有沒有Reddit都在慶祝川普確診的八卦,Fri Oct  2 13:41:01 2020
9,3,6,Sandra777 (珊朵拉),[問卦] 欸 在麥當勞丟垃圾 不分類的都什麼人,Wed Oct  7 18:09:17 2020
0,13,-13,bensonwood (班木),[爆卦] 台彩刮刮樂的設計者的都不讀書嗎？,Fri Oct  2 14:47:49 2020
9,1,8,LeeAnAn (就值得了愛，就值得了等),[問卦] 碩士念什麼所最慘？,Wed Oct  7 16:55:56 2020
7,1,6,orfan (當個快樂的邊緣人~),[問卦] 為什麼冰淇淋紅茶是給粗吸管啊,Wed Oct  7 17:07:34 2020
990,66,924,ubcs (覺★青年超冒險蓋),[公告] 中秋連假線上烤肉兼置底聯誼閒聊區,Wed Sep 30 23:45:49 2020
3,2,1,xzcb2008 (嘿嘿我很變態歐),[問卦] =.= 有沒有賣塊公務員油土伯阿神的八卦,Wed Oct  7 19:30:01 2020
7,1,6,ccyaztfe (best_troll_tw),[問卦] 看到俯衝轟炸機衝過來的士兵在想啥？,Wed Oct  7 16:28:03 2020
3,0,3,jason851124 (YeeeEX),[問卦] 台灣情趣用品店怎麼那麼多？,Wed Oct  7 21:25:53 2020
3,4,-1,algebraic (algebraic),[問卦] 學弟想面交,Fri Oct  2 11:56:49 2020
8,21,-13,jt910203 (aa),[問卦] 唐綺陽預言很準的八卦,Fri Oct  2 13:35:12 2020
9,1,8,Qoo302 (Qoo~),[問卦] 有沒有什麼歌是台灣國慶應該必唱的？,Fri Oct  2 13:08:50 2020
33,3,30,k90209 (k90209),[問卦] 中共到底紀念孫中山幹嘛？,Fri Oct  2 12:13:01 2020
13,5,8,BlueANSI (藍色),[問卦] 私立大學分前後段是不是假議題？,Wed Oct  7 18:53:59 2020
4,1,3,ryusenming ( ),[問卦] 拿熟女穿一天的絲襪來尻槍是什麼感覺,Wed Oct  7 20:49:08 2020
4,0,4,NagahamaNeru (睡睡的老公),[新聞] 35隻猴子打群架　踩塌樓房壓死屋主和工人,Wed Oct  7 20:36:41 2020
35,7,28,CHL98 (CHL),[新聞] 吃完牛肉麵稱「老闆送錯了」奧客只付陽春,Wed Oct  7 19:16:54 2020
3,2,1,you495 (哭哭),[問卦] 老闆怎麼還不放蝦,Fri Oct  2 14:02:33 2020
85,6,79,Scathach (紫色BBA),[問卦] 27歲 人生終於到盡頭了,Wed Oct  7 17:42:34 2020
8,4,4,Flitz (費爾),[問卦] 一般人可以把hangten穿得很潮嗎,Fri Oct  2 11:36:43 2020
28,78,-50,vntlu (),[新聞] 傳柯文哲一度想出席！國慶日退將辦「反台,Wed Oct  7 17:45:40 2020
6,0,6,Gazooli (窩4肥宅),[問卦] 烤懶較怎麼烤才好吃,Fri Oct  2 13:29:39 2020
1,10,-9,ilovebunnies (bunny),[問卦] 鄉民會眼皮跳嗎,Wed Oct  7 16:38:34 2020
2,4,-2,Wardyal (pekomiko),[問卦] 甚麼是快樂？,Wed Oct  7 18:11:55 2020
6,24,-18,nba887215 (方塊馬),[新聞] 反駁賣台　周錫瑋：國民黨什麼時候對大,Fri Oct  2 11:58:54 2020
15,2,13,silbermond (...),[新聞] 大象絕望嚼食垃圾!攝影師跟蹤骨瘦如柴的,Wed Oct  7 17:27:30 2020
6,2,4,Gazooli (窩4肥宅),[問卦] 中秋禮金只有200怎辦,Fri Oct  2 14:11:25 2020
0,0,0,el790124 (噓噓),[問卦] 城市尋寶是個什麼樣的活動,Fri Oct  2 14:37:31 2020
2,15,-13,jasd1786 (假橡膠樹),[問卦] 中秋連假第二天應該沒人會噓了吧？,Fri Oct  2 14:11:32 2020
8,0,8,sulanpa (...),[新聞] 揚言殺孩子、打斷親生女兒腿 法官准惡爸,Wed Oct  7 19:35:31 2020
6,5,1,FuyumiIrisu (入須冬実),[新聞] 每月捐薪水1%　永達保經8年捐64輛長照專車,Wed Oct  7 19:10:28 2020
2,0,2,aquaair (aquaair),[問卦] 沒塞車是不是大家改雙十才出遊啊？,Fri Oct  2 11:35:29 2020
0,0,0,serenitymice (肥肥超越者),[問卦] 你說自由就像一陣風,Wed Oct  7 20:56:10 2020
4,0,4,r5e97nk63 (DoUNo),[問卦] 拜登中標的機率？,Fri Oct  2 13:35:31 2020
11,0,11,Pamplona (￣︶￣),[問卦] 川普是高危險族群吧！,Fri Oct  2 13:54:23 2020
2,2,0,tigotigo5566 (鐵劍5566),[問卦] 羅志祥在微博慶賀雙節的八卦？,Fri Oct  2 13:11:22 2020
1,1,0,dasuininder (硬派大叔),[問卦] 肥宅的嘔吐物能賣多少？,Wed Oct  7 19:16:06 2020
6,5,1,thejackys (肥波),[問卦] 約克羊會看綿羊料理嗎,Wed Oct  7 17:44:44 2020
7,1,6,akanishiking (arnold jackson),[問卦] 有沒有芭樂特的八卦？,Fri Oct  2 12:07:53 2020
16,0,16,LEEWY (芸兒),[問卦] 現在還有人固定14天買全家人的口罩嗎,Fri Oct  2 15:10:55 2020
3,0,3,qskingq (勾勾),[問卦] 現在換成彭斯的話，中國會有多慘呢？,Fri Oct  2 13:31:58 2020
7,4,3,F16V (んなあああああああああ),[新聞] 局長遭爆料！軍情局駁斥醜聞不排除提告,Wed Oct  7 19:42:41 2020
7,1,6,Qoo2222 (Qoo2222上來說是 但是缺3),[問卦] 為何雪隧昨天一路暢通？？,Fri Oct  2 13:40:28 2020
7,2,5,bob120400 (花滿樓),[問卦] 小心「港版國安法」地雷,Wed Oct  7 17:12:32 2020
1,1,0,as1885 (甲文44),[問卦] 為什麼禿頭會有大鬍子？,Wed Oct  7 18:28:17 2020
6,1,5,Starcraft3 (小藥丸),[問卦] 肖戰為什麼沒有出現在中秋晚會上？,Fri Oct  2 12:56:07 2020
5,0,5,nogood (nogood),[問卦] 川普選舉花招是不是一直學台灣？,Fri Oct  2 12:28:30 2020
6,1,5,eugene31431 (eugene31431),[問卦] 該請美國爸爸來臺灣治療了吧？,Fri Oct  2 14:04:28 2020
7,3,4,LineageM (天堂M),[問卦] 隔壁女鄰居來借幾包麵？該借嗎,Wed Oct  7 21:09:56 2020
13,4,9,YU0121 (愛玉冰™),[問卦] 女生要的很簡單 到底多簡單？,Wed Oct  7 17:51:03 2020
7,1,6,lianpig5566 (家庭教師殺手里包恩),[新聞] 老翁開賓士撞上16輛汽機車 自稱「閃車才,Wed Oct  7 20:50:51 2020
10,1,9,soulboy330 (stay the course),[問卦] 古代真的有可能把城門撞開嗎？,Wed Oct  7 19:11:54 2020
13,4,9,onepunchgg (onepunchgg),[問卦] 第一次坐捷運要注意什麼,Wed Oct  7 18:15:49 2020
5,0,5,markban (馬克白),[問卦] 美國的華萊士有倒在地上哭嗎？,Fri Oct  2 13:15:45 2020
54,15,39,Rrrxddd (有噴蛤蜊 RR),[新聞] 藍營提案「台美復交」 蔡英文疑問：國民,Wed Oct  7 18:17:42 2020
3,1,2,mlb99551155 (mlb995511),[問卦] 川普體內病毒在想什麼？,Fri Oct  2 13:24:46 2020
26,5,21,nchum102 (),[問卦] 臺灣如果有顆核彈是不是中國就閉嘴了,Fri Oct  2 12:58:20 2020
31,10,21,brokenback3 (3),[問卦]中國軍機靠近台灣若被打下 他們敢開戰？,Wed Oct  7 16:13:07 2020
9,1,8,yangzy (亞瑟),[問卦] 美國總統有病被隔離時可射核彈嗎？,Fri Oct  2 14:22:49 2020
8,0,8,happyjames1 (快樂詹姆士1號),[問卦] 川普推特為什麼一堆阿姆哈拉文推文？,Fri Oct  2 13:26:56 2020
25,7,18,ffreakk (),[問卦] 隨便說三個玩過三年的遊戲,Wed Oct  7 17:47:19 2020
43,0,43,EvilisGood (Hustler),[爆卦] 幕僚確診後 川普跑去參加餐會,Fri Oct  2 14:45:14 2020
3,1,2,linhu8883324 (SirLinhu),[新聞] 勤洗手防疫台北市每人每日家庭用水量創10,Wed Oct  7 19:41:19 2020
1,2,-1,Nemowei (fsn9665),[問卦] 還有什麼新聞可看啊,Fri Oct  2 14:14:06 2020
12,0,12,cmelo1515 (瓜農),[問卦] 滿手台積電的還吃得下烤肉嗎？,Fri Oct  2 13:12:51 2020
8,1,7,pl132 (pl132),[新聞]解放軍何時會攻打台灣沈富雄預測：起碼還要30年,Fri Oct  2 15:01:07 2020
4,5,-1,Pamplona (￣︶￣),[問卦] 美國人會怎麼跟中國算帳？,Fri Oct  2 13:41:17 2020
14,6,8,AsllaPiscu (阿斯拉),[問卦] 今天為什麼要降半旗,Wed Oct  7 17:19:12 2020
6,0,6,Audien (Audien),[問卦] 為啥川普確診一堆人po限時動態？,Fri Oct  2 15:35:18 2020
4,0,4,LoveMakeLove (ボケ),[問卦] 五星旗現在哪裡可以買？,Fri Oct  2 15:30:36 2020
5,1,4,aivxg (家裡窮西索XD),[問卦] 有沒有後XX的八卦？,Wed Oct  7 20:00:14 2020
12,5,7,gay7788 (卡稱之神=卡神),[問卦] 慟！中秋連烤4天肉，到現在還沒拉屎！,Wed Oct  7 16:57:31 2020
2,5,-3,spartaucs896 (夢醒十分),[問卦] 亞美尼亞女現在願意嫁給台男嗎,Fri Oct  2 15:33:06 2020
27,2,25,jiouje (JioUje),[問卦] 中共小粉紅很想跟美國打戰啊？,Fri Oct  2 13:59:14 2020
3,0,3,humbler (獸人H),[問卦] 胡天蘭吃到美豬會說什麼？,Wed Oct  7 17:58:11 2020
3,2,1,coga4712 (海森堡),[問卦] 為什麼勁舞團當年會很多人玩,Fri Oct  2 11:40:37 2020
359,11,348,polanco (polanco),[新聞] 美國總統川普與第一夫人梅蘭妮亞新冠肺,Fri Oct  2 13:11:38 2020
24,18,6,"ots625 (歐踢Sk蓴    ,噤>鐝ud  巽r)",[問卦] 咱們817覺青不怕打仗,Wed Oct  7 17:11:00 2020
11,0,11,missingkid (),[問卦] 30歲前年收300萬的人生活是什麼樣子,Wed Oct  7 18:20:12 2020
4,1,3,ambitious (Andrew),[問卦] 等下班的垃圾時間可以幹嘛,Wed Oct  7 17:01:07 2020
1,1,0,en5151 (asenen),[問卦] 如果立法院拍youtobe開頻道有搞頭嗎？,Wed Oct  7 21:07:32 2020
13,4,9,Yolosnow (生活很無聊),[問卦] 有大腸鏡跟胃鏡都做過的鄉民嗎？,Fri Oct  2 12:35:55 2020
2,0,2,sushi11 (偶像可以亂摸嗎peko),[問卦] 為什麼不讓機車在內車道,Wed Oct  7 20:56:35 2020
5,1,4,markban (馬克白),[問卦] 川普跟拜登可能進入四人賭命賽？,Fri Oct  2 11:52:59 2020
6,16,-10,ssss0960193 (愛莉莎莎後援會楓谷部長),[問卦] 愛莉莎莎仙氣側臉，網驚呼：臺灣IU,Wed Oct  7 20:06:12 2020
62,2,60,chucky (衛藤x白石x橋本),[新聞] 快訊／川普夫婦確診新冠肺炎 即刻開始隔,Fri Oct  2 13:24:11 2020
7,5,2,AlphaPTT (阿爾法+PTT),[問卦] iPhone的記憶體會不會少得可憐啊,Wed Oct  7 20:23:27 2020
1,1,0,ryhma (hmä),[問卦] 妳的網誌成了我秘密基地,Fri Oct  2 13:36:13 2020
10,3,7,liuyihui (臺北然也),[問卦] 我的經歷是中國社會的縮影嗎？,Wed Oct  7 18:54:54 2020
19,4,15,silentknight (清純男),[新聞] 熱戀ing衝公廁纏綿！男大生慘挨告　12歲,Wed Oct  7 18:02:36 2020
10,1,9,barucher (芭樂),[問卦] 請問有沒有防貓貓搶飯的方法,Fri Oct  2 13:09:20 2020
1,1,0,edge112233 (忍者龜頭痛),[問卦] 美式豬肋排要用美豬還是台豬啊？,Fri Oct  2 12:16:37 2020
2,1,1,EricTCartman (阿ㄆㄧㄚˇ),[問卦] 哪個地區的麻將最智障？哪個最講技術？,Fri Oct  2 11:57:21 2020
11,7,4,qazxsw123 (小新),[問卦] 融資是什麼意思阿,Wed Oct  7 20:19:17 2020
9,11,-2,googolplex (googolplex),[爆卦] 最新美國6大搖擺州民調 川普選情持續穩定,Wed Oct  7 16:57:38 2020
8,0,8,sysop5566 (馬丁路德),[問卦] 四大科缺人 是哪四大？,Fri Oct  2 11:47:03 2020
6,0,6,Tsuzichen (Zoo),[問卦] 孤單的朋友看到烤肉動態要來參加 怎辦,Fri Oct  2 12:17:04 2020
10,3,7,gentleman888 (),[問卦] 女生都怎麼玩肥宅的雞雞？☺☺☺,Fri Oct  2 14:18:29 2020
12,2,10,tw2000 (天滅中共),[新聞] 機車路考沒過！他「誇張180度大擺頭」網,Wed Oct  7 19:11:01 2020
2,0,2,mvpdirk712 (Lumia 5566),[問卦] 所以匝道上國五大概要塞多久啊？,Fri Oct  2 13:07:42 2020
3,1,2,CATpc (JIA),[問卦] 中獎反而更賭爛？？？,Wed Oct  7 18:02:13 2020
3,1,2,catrush (貓兒衝鋒),[問卦] 健身房教練好賺嗎？,Fri Oct  2 15:05:14 2020
19,4,15,AllBlack (All Black),[問卦] 台灣的房子那麼醜，建築師要負一半責任吧,Wed Oct  7 16:57:23 2020
0,4,-4,cowboyas0413 (RAID0一時爽 資料火葬場),[問卦] 對不起我騙了妳,Wed Oct  7 21:25:42 2020
11,7,4,Elsie1999 (艾兒),[問卦] 富堅有沒有考慮畫完獵人,Wed Oct  7 18:26:41 2020
5,3,2,chadmu (查德姆),[問卦] 南港為什麼在北部,Wed Oct  7 20:36:39 2020
7,4,3,yogurt0313 (愛草莓),[問卦] 演化後為什麼要一公一母才可以繁衍,Wed Oct  7 17:30:38 2020
1,2,-1,LoveMakeLove (ボケ),[問卦] 乾脆抓監獄重刑犯和8+9充軍不就好了？,Wed Oct  7 21:09:46 2020
15,0,15,chienyu2001 (花開花落自有時),[問卦] 川普推特留言發生什麼事？,Fri Oct  2 13:40:46 2020
11,0,11,polomax (阿do),[協尋] 台北市內湖區樂群二路265巷路口 行車紀錄,Sun Oct  4 18:42:55 2020
3,1,2,Julian9x9x9 (Lets Get It On～),[問卦] 如果我川跟拜登都中標美國要怎麼辦？,Fri Oct  2 13:10:05 2020
14,0,14,subcrew (Working Below The Hype),[問卦] 高爾夫球跟賽車誰更無聊,Fri Oct  2 14:50:22 2020
5,0,5,CurryMvp (^______^),[問卦] 川普防疫能力是不是蠻猛的啊？,Fri Oct  2 13:44:28 2020
2,0,2,opfish (coco),[問卦] 吳剛是不是隔壁老王,Fri Oct  2 11:56:23 2020
9,0,9,BIA (必亞),[問卦] 我川不是有天天吃奎寧？,Fri Oct  2 15:01:22 2020
66,1,65,derekhsu (華麗的天下無雙),[爆卦] [疫情] 全球死亡創紀錄 爆出巨量阿根廷,Fri Oct  2 12:41:56 2020
1,2,-1,TtTt4 (夜間飛行),[問卦] 梅子綠有推薦的嗎,Wed Oct  7 20:04:20 2020
1,0,1,SilentestLam (SilentestLamb),[問卦] 教授484不喜歡待在學校？,Fri Oct  2 15:06:10 2020
11,13,-2,ToHsiang (誤上賊船),[新聞] 蘇貞昌不容許陳同佳自由來台 港議員：投案,Wed Oct  7 19:00:41 2020
5,7,-2,botnet (殭屍網路),[問卦] 有沒有台北火車站的八卦,Wed Oct  7 19:16:52 2020
16,13,3,lovea (lovea),[新聞] 豬農百億基金規劃出爐！ 陳吉仲︰46億升,Wed Oct  7 18:16:40 2020
2,0,2,toomtoom (monteport),[問卦] 教授問我主流文化的特點,Wed Oct  7 20:50:43 2020
0,3,-3,thumbsptt (山拇指),[問卦] 大家住的地方多久一次會抽水肥,Wed Oct  7 20:40:18 2020
10,4,6,Matz (イラマチオ研究員),[新聞] 聖約翰遭控欠薪 校方：教師不願商議,Wed Oct  7 18:01:22 2020
10,7,3,s5869157 (肥皂泡的世界),[問卦] 年薪140萬  台北市買房可以買哪裡,Wed Oct  7 17:43:19 2020
22,3,19,MrFly (MrFly),[問卦] 這波如果在台灣 候選人會怎麼操作,Fri Oct  2 14:19:38 2020
4,3,1,purue (purue),[問卦] 台灣還有哪些景點有救,Wed Oct  7 17:14:15 2020
2,1,1,n123456n (米修),[問卦] 古墓奇兵2018有無拍續集的卦,Fri Oct  2 11:59:56 2020
8,3,5,yamakazi (大安吳彥祖),[問卦] 買雙螢幕還是寬曲面螢幕？,Wed Oct  7 19:07:28 2020
1,1,0,johanLarson (Rent),[問卦] 這算中國暗殺成功嗎？,Fri Oct  2 13:48:29 2020
92,5,87,f17690815 (我恨陣頭),[問卦] 拜登現在在想什麼,Fri Oct  2 13:18:30 2020
11,1,10,westdoorcard (West),[問卦] 幹！有白目機車騎在禁行機車上,Wed Oct  7 18:41:12 2020
10,9,1,gn116187 (NGT),[問卦] 「八卦板五毛」會不會是空氣稻草人,Wed Oct  7 17:36:41 2020
7,1,6,qsxwdc (Moo),[問卦] 瘋狂十月開始了嗎？,Fri Oct  2 13:42:19 2020
5,7,-2,ATTwo (咖哩給Gay),[問卦] 為啥電動車還不能自動充電？,Wed Oct  7 16:28:30 2020
9,2,7,a88241050 (再回頭已是百殘身),[問卦] 認真問，長痔瘡怎麼辦..,Fri Oct  2 12:47:13 2020
20,1,19,qazxc1156892 (QQ),[新聞] 35隻猴子打群架 踩塌樓房壓死屋主和工人,Wed Oct  7 20:31:48 2020
28,7,21,Yamamoto5566 (大日本帝國．山本56),[問卦] 魚的台語,Fri Oct  2 12:26:27 2020
5,5,0,ai770116 (東方的神秘力量),[問卦] 川普超沒水準都不戴口罩PTT還挺川普？,Wed Oct  7 21:25:21 2020
6,7,-1,oftisa (oo),[問卦] 國家太空中心是不是騙錢用的？,Fri Oct  2 14:39:19 2020
0,0,0,llgod (Wryyyyyyyy),[問卦] 噁茫啊斯是不是超好玩超心機,Wed Oct  7 21:27:58 2020
6,0,6,Triceratops (Jurassic),[新聞] 川普下令解密通俄門調查所有文檔,Wed Oct  7 19:14:05 2020
14,2,12,botnet (殭屍網路),[問卦] 核彈投中國哪，台灣才不會被波及？,Fri Oct  2 15:03:55 2020
21,3,18,WuDunE (GLAUCUS),[問卦] 正妹香味從哪來的,Wed Oct  7 18:04:29 2020
1,0,1,z041l31l3 (z041l31l3),[新聞] WTO上修2020世界貿易量，回復至減少9%,Wed Oct  7 16:37:55 2020
2,0,2,Dinenger (低能兒),[問卦] 根本就是以前太多智障用路人吧？,Fri Oct  2 13:46:52 2020
7,1,6,MeowDeLay (喵的勒),[新聞] 營養午餐文宣挨批宣傳美豬 教部：食農教,Wed Oct  7 20:34:21 2020
0,0,0,kaiting00 (),[問卦] 支那的生化戰是不是成功了？,Fri Oct  2 13:26:10 2020
8,3,5,HomeTogether (人在歸途),[新聞] 蓬佩奧：若中共攻台 美軍不會袖手旁觀,Wed Oct  7 20:36:19 2020
13,0,13,david0426 (軒軒寶貝),[問卦] 習近平會怎麼回應關於川普中標這件事,Fri Oct  2 13:43:12 2020
14,4,10,soi1dsnake (索立德史捏克),[新聞] 8歲時遭性侵身心受創 15年後打開心結將狼,Wed Oct  7 20:12:24 2020
7,6,1,cimo764 (蘋果西打),[新聞] 「準備」選國民黨主席 周錫瑋：與韓國瑜,Fri Oct  2 13:47:57 2020
6,1,5,gaexp256016 (gaexp256016),[問卦] 支那維尼,Fri Oct  2 14:07:55 2020
21,7,14,taker627 (你馬英九嗎?),[問卦] 有些地方坐高鐵是不是沒有比較快啊,Wed Oct  7 17:04:14 2020
8,5,3,star07 (),[問卦] 如果臺灣有一個航母戰鬥群,Fri Oct  2 15:01:24 2020
8,3,5,genheit (genheit),[問卦] 當時蜀國怎麼不南下取緬甸、泰國？,Wed Oct  7 21:07:10 2020
1,2,-1,s910408 (真姬俺の嫁),[問卦] 跟網友見面是直銷的八卦,Fri Oct  2 13:44:52 2020
5,3,2,k44754 (9527),[新聞] 藍委提修社維法 毒駕、酒駕致死傷拘留3,Wed Oct  7 20:56:52 2020
2,2,0,Kitakami (公主連結特約工讀生),[問卦] 肥宅會假裝自己有去烤肉嗎？,Fri Oct  2 12:12:12 2020
22,5,17,LastDinosaur (LastDino),[問卦] 梁社漢好吃在哪,Wed Oct  7 19:31:56 2020
5,0,5,jedfjeff8673 (哈囉),[問卦] 現在是進場美股的時機嗎,Fri Oct  2 14:01:24 2020
0,0,0,james7923 (詹姆士Q),[問卦] 我~與 各位共清歡  我~笑 眾人看不穿,Fri Oct  2 14:17:17 2020
0,1,-1,zxcv820421 (水原千鶴我老婆),[問卦] 每天都要聽一次守望傳說廣告？,Wed Oct  7 16:36:41 2020
3,1,2,johnny9667 (大八),[問卦] 台灣人工時高於韓國但年均卻低於韓,Fri Oct  2 13:22:03 2020
3,1,2,belucky (),[問卦] 為何有些蚊子寧可被打死也要吸血,Wed Oct  7 16:42:07 2020
11,5,6,ezJapan (Japan),[新聞] 蝦腳抱一排「橘色顆粒」 內行驚曝：吃完秒睡醫院,Wed Oct  7 20:45:05 2020
3,0,3,Brown1010 (0W0),[問卦] 美股是不是要爆漲了？,Fri Oct  2 14:48:23 2020
6,7,-1,zzyyxx77 (討噓大師77),[問卦] 為什要吃保健食品？,Wed Oct  7 17:33:24 2020
3,1,2,a12141623 (舔舔老二再泡泡茶),[問卦] 歐美人不認真封城是不是智障？,Fri Oct  2 11:44:47 2020
6,2,4,a9606093 (呢喃貓),[新聞] 美眾議員提案：指定中共為跨國犯罪組織,Fri Oct  2 12:01:55 2020
32,0,32,q0975190339 (chang751),[問卦] 在田裡撿到刺蝟，該怎麼處置,Fri Oct  2 13:27:01 2020
11,0,11,sodistrues (true),[問卦]乃木坂有可能像AKB一樣 讓10世代接班嗎？,Wed Oct  7 20:20:03 2020
6,13,-7,rasiel0919 (小弟弟),[問卦] 你各位啊，老實說被統一又如何,Fri Oct  2 13:24:37 2020
4,0,4,Gary5566 (等我長大要娶天音かなた),[問卦] 星街彗星的老公都給我進來,Fri Oct  2 12:17:55 2020
0,0,0,AV5566 (射即是空),[問卦] 有沒有高雄冠軍哥的八卦？,Fri Oct  2 15:08:55 2020
3,0,3,justin777 (JUSTIN),[新聞] 民團盼比照短期商務客模式 讓跨國伴侶有,Wed Oct  7 16:58:37 2020
26,8,18,yank0612 (魯宅),[問卦] 川普中鏢 支那現在很爽嗎,Fri Oct  2 13:48:02 2020
5,2,3,somanyee (Soman),[問卦] 各位每天用最久的app是哪個？,Fri Oct  2 12:16:42 2020
5,3,2,zoriyah (\^O^/BA),[問卦] 不買星巴克可以去星巴克裡面坐著嗎？,Wed Oct  7 18:41:21 2020
24,10,14,chiafann (NAZZZ),[問卦] 你覺得罰歐陽娜娜50萬合理嗎？,Fri Oct  2 11:41:22 2020
3,2,1,Giddcns (狠、插、勁！！！),[問卦] 美國人484很懂談判？,Wed Oct  7 20:15:50 2020
1,4,-3,ILoveMegumin (白上吹雪的刻印蟲),[問卦] 日本的鐵路比台灣進步很多,Wed Oct  7 21:21:20 2020
46,3,43,qazsedcft (自由羊),[新聞] 高加索血戰破百死：亞美尼亞禁止役齡男,Fri Oct  2 12:15:30 2020
11,3,8,ME13 (小鳥),[問卦] 有喜歡吃大蒜泥的嬰幼兒嗎,Wed Oct  7 18:44:49 2020
1,4,-3,eierom (非),[問卦] 川普中標是中共幹的吧？,Fri Oct  2 13:27:14 2020
13,0,13,Scathach (紫色BBA),[問卦] 川普和拜登都死於肺炎會怎樣,Fri Oct  2 13:38:12 2020
16,2,14,NccuShuai (政帥),"[問卦] 寫個""純"" 是什麼意思",Wed Oct  7 19:20:15 2020
17,55,-38,googolplex (googolplex),[爆卦] 中國新的實驗性疫苗證實安全有效,Wed Oct  7 19:16:47 2020
5,2,3,HappyDiD (開心的動一動),[問卦] 保健食品怎麼挑啊？,Wed Oct  7 17:22:53 2020
7,1,6,ann141414 (海底撈火鍋),[問卦] 會去打工換宿的人腦中都在想甚麼阿,Wed Oct  7 16:38:03 2020
4,4,0,iamhyaline (也太好了吧),[問卦] 血溶性貧血到底要禁鐵還是補充鐵,Fri Oct  2 14:46:53 2020
12,1,11,chia0220 (憨魚一號),[問卦] 南投有人聽過阿霞蛋捲ㄇ,Fri Oct  2 15:11:11 2020
8,10,-2,rocephin (Roce),[問卦] 一堆台大法律系的 卻處理不了歐陽娜娜？,Fri Oct  2 12:30:43 2020
2,1,1,thewtf (濱邊美波我老婆),[問卦] 你不是怪物 別害怕 誰來欺負,Wed Oct  7 20:47:04 2020
2,11,-9,daria1217 (yuki),[問卦] 下午茶這樣100塊？,Wed Oct  7 16:26:51 2020
12,1,11,XXXXHAY (過氣ID),[問卦] 真的有人幹過羊嗎,Wed Oct  7 19:42:42 2020
4,1,3,gs056119 (Eggtart),[問卦] 醬油為什麼要用碟子啊,Wed Oct  7 17:53:35 2020
5,1,4,IOP14759 (iop14759),[問卦] 為啥總有人以為交通亂很重要？,Wed Oct  7 18:11:21 2020
6,8,-2,LAPDSWAT456 (胖達稱霸地球),[問卦] 戰爭時期殘忍殺害統畜會犯法嗎？,Fri Oct  2 12:06:39 2020
15,5,10,masterbation (貝森大師),[問卦] 川普的票倉其實在台灣吧？,Fri Oct  2 11:50:58 2020
1,1,0,deeeplove (想不到ID),[問卦] 朋友這盒太陽餅是什麼意思,Fri Oct  2 15:23:20 2020
0,5,-5,Metallicat (金屬製貓),[問卦] 有美國小鬼(黃鴻升)-范海倫的八卦嗎,Wed Oct  7 19:00:33 2020
10,9,1,cheerbu (buchi),[新聞] 遭柯文哲批「說謊」 王世堅反嗆：liar憑,Wed Oct  7 21:11:56 2020
7,0,7,chen740530 (chen740530),[問卦] 川普被隔離 會視訊跟拜登辯論嗎？,Fri Oct  2 13:38:15 2020
11,2,9,chen740530 (chen740530),[問卦] 太守丁原為何敢偷襲董卓駐守洛陽的西涼兵,Wed Oct  7 17:00:14 2020
7,0,7,x851221 (SuperDog),[問卦] 為什麼海洋生物吃魚不怕魚刺,Fri Oct  2 13:38:32 2020
6,1,5,ann141414 (海底撈火鍋),[問卦] 拜登是不是也要下去了阿,Fri Oct  2 13:31:36 2020
2,0,2,z0953781935 (妹妹罵我是肥豬>///<),[問卦] 為啥墨西哥在美國旁邊還那麼窮啊？,Fri Oct  2 13:08:10 2020
18,1,17,Conan5566 (連續殺人),[問卦] 強生會對川普說什麼？,Fri Oct  2 13:33:02 2020
11,1,10,heavenlyken (銀狐),[問卦] 為什麼日本超商很多外國店員但台灣沒有？,Wed Oct  7 21:03:54 2020
20,6,14,iou861007 (中壢金城武),[問卦] 部隊的食物很難吃怎麼辦？,Wed Oct  7 19:49:54 2020
17,2,15,irita123 (笑容很重要~),[新聞] 北市東湖國小後方變電箱爆炸 民宅停電所,Wed Oct  7 19:47:42 2020
0,0,0,melissalewis (龍使弗利茲),[問卦] 美國現在會跪還是脆了？,Fri Oct  2 13:27:25 2020
8,4,4,lauwei (lauwei),[問卦] 台南的50嵐也太少了吧？？,Fri Oct  2 12:53:59 2020
36,1,35,b10485762000 (台北寂寞部屋),[新聞] 魔音洗腦！美獄警逼受刑人聽2小時「Baby,Wed Oct  7 21:12:38 2020
0,0,0,B0858B (),[新聞] 吉普車撞機車後逃逸 歐吉桑騎機車勇追5公,Fri Oct  2 13:35:52 2020
18,1,17,vikk33 (vikk33),[爆卦] 川普中標韓國反應,Fri Oct  2 14:31:24 2020
21,5,16,footart (reminiscence),[問卦] 人類到底有沒有登陸月球過,Fri Oct  2 14:26:55 2020
52,22,30,uei1201 (新八),[問卦] 被UBER EAT嗆不要送上樓怎麼辦,Fri Oct  2 12:05:42 2020
0,0,0,norgthas (norgthas),[問卦]關於適應極端氣候的問題 醫森醫學系生請進,Wed Oct  7 21:32:04 2020
3,1,2,zakijudelo (Zack),[問卦] 中共侵台，台灣黑道會是潛在內奸？,Fri Oct  2 12:22:32 2020
5,1,4,tony77998 (偷尼柒柒玖玖捌),[新聞] 與女友吵架竟放火燒她家 警調監視器揪出,Wed Oct  7 20:24:53 2020
15,3,12,Lucky0105 (洋),[問卦] baby shark為什麼能67億點閱率？,Wed Oct  7 17:52:43 2020
2,0,2,hstf (馬刺贏球就是爽\⊙▽⊙/),[問卦] 以後飛彈是不是改用病毒就好,Fri Oct  2 14:37:36 2020
8,2,6,yhltyy (大堡礁),[問卦] 無事不登三寶殿 是哪三寶,Wed Oct  7 21:07:53 2020
1,0,1,wakaura (wakaura),[問卦] 單身宅適合加入烏伯外送的月費方案嗎？,Fri Oct  2 14:52:48 2020
2,0,2,scum5566 (你好宅),[新聞] 俄羅斯也嚴查中國竊密 俄國科學家被捕面,Fri Oct  2 14:43:53 2020
1,3,-2,bebehome (bebehome),[問卦] 徵兵如果改這樣會不會一堆人簽？,Wed Oct  7 18:44:01 2020
6,1,5,p5360708 (),[新聞] 真．海底撈機車！安全帽、輪框「全面鏽,Fri Oct  2 13:50:23 2020
3,0,3,DamnKobe (KoberInNTHU),[問卦] 現在歌頌習近平來得及嗎,Fri Oct  2 13:05:49 2020
32,14,18,autoimmune (..),[新聞] 藍喊台美復交 陳柏惟：可跟中國建交,Wed Oct  7 21:23:38 2020
12,3,9,Aloee (柯粉),[問卦] 黑人祖宗為何走到亞洲屌就變小了,Wed Oct  7 18:49:16 2020
13,0,13,jiouje (JioUje),[問卦] 911事件、川普死於武肺 那個比較嚴重？,Fri Oct  2 13:07:56 2020
13,2,11,HyperPoro (TomorrowIsInYourHands),[問卦] 南韓人均GDP今年會跌破3萬鎂？,Wed Oct  7 16:58:14 2020
4,1,3,ayaneoshi (小坂菜緒は俺の嫁),[問卦] 夜よ 僕に歌わせるなよ,Wed Oct  7 20:52:58 2020
8,7,1,emperor (派蘿派蘿得第一),[新聞] 女兵好悍！ 5字經怒嗆長官遭判罰1萬元,Wed Oct  7 16:58:08 2020
2,1,1,iecju520 (哎依喜德魯),[問卦] 這次武統新聞要掩蓋什麼,Wed Oct  7 20:12:37 2020
10,1,9,kikiki37 (441),[問卦] 冷氣一個人吹和兩個人吹電費有差嗎？,Fri Oct  2 14:12:47 2020
4,3,1,xampp (xampp),[問卦] 拜登超穩的吧,Fri Oct  2 13:53:12 2020
44,7,37,pillliq (o皿o),[新聞] 股市老師line揪團報明牌　3天崩盤16萬賠,Fri Oct  2 11:42:09 2020
5,5,0,limoncool (中国共产党杀光台独贱畜),[問卦] 現在是不是血洗台灣最佳時機,Fri Oct  2 13:24:04 2020
3,1,2,royroy666 (老鼠),[問卦] 選前一個月超級震撼彈！！,Fri Oct  2 13:21:47 2020
0,1,-1,stuj9019 (肥宅好吃 ^Q^),[問卦] 滯台美國人會回去投票嗎,Fri Oct  2 12:21:53 2020
8,2,6,funasake (),[問卦] 去日本一定要買什麼東西？,Fri Oct  2 11:31:17 2020
1,0,1,NTUST (國立金城武科技大學),[問卦] Onlyfans有什麼推薦追蹤的帳號嗎？,Fri Oct  2 12:55:11 2020
1,1,0,EmeraldAZ (小穹控),[問卦] 小穹的生日賀卡到啦>< (小穹陣線),Wed Oct  7 18:26:15 2020
9,1,8,ginopun10477 (南瓜薯叔),[問卦] 十個廣告七個是手遊,Fri Oct  2 12:01:16 2020
7,3,4,Davichi5566 (如果從此不見面),[問卦] 去教召查詢系統查自己資料會被紀錄嗎？,Wed Oct  7 19:51:15 2020
22,1,21,Francise (少喝飲料多喝水),[新聞] 竹聯幫內訌！萬華大亂鬥砍死人　賭場利,Wed Oct  7 21:26:36 2020
8,10,-2,norvasc (Norton),[問卦] 跟愛莉莎莎同房一晚給10萬  你ok嗎？,Fri Oct  2 12:37:23 2020
16,9,7,KeepHard (0.0),[問卦] 中國大奶妹全來台灣是不是就和平統一了？,Fri Oct  2 14:27:59 2020
4,0,4,Superxixai (洪粉吱已),[問卦] 社會上阿薩布魯的人也太多了吧？,Wed Oct  7 20:36:21 2020
6,0,6,chihchingho (松艄辣g),[問卦] 沒人關心伊凡卡嗎？,Fri Oct  2 14:59:52 2020
6,5,1,maybetodo (np),[問卦] 教召14天含放假嗎？,Wed Oct  7 19:55:23 2020
20,2,18,pupss89177 (asshole young),[問卦] 咳三個月了怎麼辦,Wed Oct  7 18:08:47 2020
1,5,-4,kingtama (立志成為唬爛王),[問卦] 地獄會不會只是另一個時空？,Wed Oct  7 20:07:20 2020
5,1,4,Rrrxddd (有噴蛤蜊 RR),[問卦] 是誰發現 香蕉 可以吃的,Wed Oct  7 21:05:22 2020
5,4,1,kevin19528 (kk19528),[問卦] 五行密碼到底是啥？,Fri Oct  2 12:38:54 2020
2,5,-3,QAQer (你為什麼不問我初戀幾歲?),[問卦] 三年級學長特製的蔬菜汁很難喝,Wed Oct  7 16:33:28 2020
31,21,10,kivan00 (Kivan),[新聞] 中芯恐遭斷頭？英媒爆川普押錯籌碼,Fri Oct  2 11:25:27 2020
3,5,-2,aleck0211 (Hitori),川普死前會公開外星人秘密嗎,Fri Oct  2 13:39:37 2020
4,7,-3,david0426 (軒軒寶貝),[問卦] iPhone用兩年 就開始發燙,Wed Oct  7 20:01:48 2020
5,14,-9,wang19980531 (中立評論員),[問卦] 美國連香港都救不了 怎麼幫台灣？,Fri Oct  2 13:28:37 2020
7,3,4,Lucky0105 (洋),[問卦] 流氓能買的起c300？賺錢能力超強？,Wed Oct  7 21:03:21 2020
7,9,-2,avpenis123 (),[問卦] 這碗鮭魚親子丼要多少？,Wed Oct  7 18:18:42 2020
3,2,1,ytkuang (就是那個光),[新聞] 逼少年「DIY」 嫌太慢 輔導老師伸手「幫,Wed Oct  7 20:53:55 2020
0,4,-4,david3809 (霜月薰),[問卦] 台男自願加班 有加分嗎？,Wed Oct  7 18:24:59 2020
7,2,5,RINPE (RIN),[問卦] 為什麼開始抽煙？,Wed Oct  7 18:15:13 2020
13,8,5,go190214 (天空之島拉普達),[新聞] 藍營推萊牛卻反萊豬「可不可恥」？ 洪孟,Wed Oct  7 19:51:16 2020
1220,43,1177,Superman007 (),[爆卦] 川普中標,Fri Oct  2 12:55:38 2020
2,4,-2,simoncha (茶或咖啡),[問卦] 愛莉莎莎包養你 多少錢可以接受,Fri Oct  2 12:35:23 2020
18,1,17,eateat14 (SHERLOCKZH),[新聞] 上萬噸事業廢棄物亂丟中彰投 環保掮客羈,Wed Oct  7 19:45:10 2020
3,0,3,wakaura (wakaura),[問卦] 應付教召有需要練身體嗎？,Wed Oct  7 20:31:23 2020
11,2,9,demandlonely (樓台下的一盞燈),[問卦] 有人機車騎上快速道路過嗎,Wed Oct  7 17:01:23 2020
0,0,0,nayeonmywife (sanamywife),[問卦] 有沒有Genshin Impact 廣告做得不錯的八,Fri Oct  2 14:29:52 2020
7,1,6,antonysole (辰辰),[問卦] 歷史上有沒有女人做了亡國之君,Fri Oct  2 14:48:00 2020
2,2,0,ergostepo (ergo),[問卦] 共機飛過來  不理它會怎樣嗎？,Wed Oct  7 17:43:44 2020
14,1,13,colset (摳機主教),[新聞] 昌鴻增強為中颱！最新路徑曝光大迴轉北上,Wed Oct  7 20:43:22 2020
2,2,0,milk8144 (>@@<),[問卦] 老闆說因為疫情不辦尾牙了？,Wed Oct  7 18:51:17 2020
0,1,-1,ME13 (小鳥),[問卦] 早餐吃烤肉吐司的人多嗎（在線吃,Fri Oct  2 12:25:58 2020
1,2,-1,cutiehoneyzu (McHilo),[問卦] 肥宅學蕭敬騰穿打洞的牛仔褲會變潮男嗎？,Wed Oct  7 20:56:41 2020
4,0,4,leepingyo (御前一品帶刀龍侍衛),[新聞] 失蹤近2年　議員爆：北韓前駐義國趙姓大,Wed Oct  7 16:43:17 2020
1,3,-2,gotopark (無限風光在險峰),[新聞] 為明年台灣燈會 交通部長林佳龍參訪新竹,Wed Oct  7 19:53:52 2020
19,9,10,asdf1256 (guest),[新聞] 學雜費凍漲15年 私大校長砲轟：干涉大學,Wed Oct  7 18:25:29 2020
5,6,-1,onepunchgg (onepunchgg),[問卦] 怎麼觸發分泌荷爾蒙,Wed Oct  7 19:24:36 2020
9,5,4,doraBBO (天才小釣手),[新聞] 史上首次「撲空」進入枯水期 桃竹苗台中4,Wed Oct  7 18:05:32 2020
14,0,14,RikaShiguma (RikaShiguma),[新聞] 微軟計畫投資10億美元 雅典建3座資料中心,Wed Oct  7 19:04:34 2020
8,1,7,ggian123 (小孩當國文老師打斷他腿),[問卦] 彭斯和賀錦麗誰最有機會當選總統,Fri Oct  2 13:22:43 2020
3,5,-2,Ketsu24 (阿可),[問卦] 有沒有諾貝爾獎排華的八卦？,Wed Oct  7 18:48:33 2020
11,4,7,fragmentwing (片翼碎夢),[新聞] 中山高湖口服務區驚傳隨機砍人 看惡煞一,Wed Oct  7 18:27:16 2020
2,0,2,STAV72 (刁民黨黨務主委),[問卦] 印度仔躺分就對了？,Fri Oct  2 13:28:46 2020
1,0,1,sup5566 (舒跑烏溜溜),[問卦] 川普有權力公佈51區的秘密嗎？,Fri Oct  2 13:45:09 2020
7,1,6,bennyalen (小周),[問卦] 預購到PS2有多爽？,Fri Oct  2 11:57:30 2020
3,11,-8,ubcs (覺★青年超冒險蓋),[公告]十月份置底閒聊區,Wed Oct  7 16:57:26 2020
25,1,24,henry100 (Henry),[問卦] 最後川普沒事，而梅蘭妮雅GG，會如何？,Fri Oct  2 13:45:29 2020
33,4,29,richshen (哇哈哈),[新聞] 婦科名醫麻醉性侵15分鐘3次 妻揭惡行：他,Wed Oct  7 20:50:28 2020
1,1,0,xxxluke (我手裡拿著小皮鞭),[問卦] 豆導會怎麼拍鬼滅真人版,Wed Oct  7 20:56:43 2020
3,2,1,oscarwu3041 (夢想家的羽毛),[問卦] 辛普森家庭想暗示什麼？,Fri Oct  2 14:25:18 2020
4,6,-2,yolin2012 (yolin),[問卦] 飲料店根本不甩禁用塑膠吸管？,Wed Oct  7 18:22:26 2020
13,5,8,sukiyasuica (suica),[新聞] 驚險！92歲老翁遭水泥車撞捲進車底 差幾,Wed Oct  7 16:12:53 2020
8,1,7,Ericz7000 (♥安潔莉卡正統老公♥),[問卦] 失去雙手的退役軍人可以做什麼工作？,Wed Oct  7 19:41:11 2020
0,3,-3,MintSu (Simon),[問卦] 要怎麼求雨？,Wed Oct  7 18:24:43 2020
2,1,1,qazxc1156892 (QQ),[問卦] 川普的十月驚奇是不是夠驚奇？,Fri Oct  2 13:27:56 2020
4,3,1,takashi01 (中和孔劉),[問卦] 欸欸為何吃火龍果大便會是紅的,Fri Oct  2 11:41:40 2020
1,0,1,LineageM (天堂M),[問卦] 希拉蕊已經準備好了嗎？,Fri Oct  2 13:34:11 2020
0,0,0,semih (Sayginer),[新聞] 桃園砸1950萬元辦萬聖節觀光活動 民代批,Wed Oct  7 21:29:43 2020
3,1,2,nonpolar (Nonpolar),[問卦] 現在郵局物流是不是很閒啊？,Wed Oct  7 16:58:46 2020
6,1,5,teeheehee (軟尾拋拋翔(′・ω・`)),[問卦] 有沒有手很小男生的八卦？,Fri Oct  2 12:04:20 2020
10,6,4,ttfan (),[新聞] 陳廷寵辦台商學校年領6000萬政府補助,Fri Oct  2 11:29:54 2020
4,0,4,dean1990 (狄恩院長),[問卦] 台灣484跟自由行星同盟越來越像惹,Fri Oct  2 12:23:46 2020
4,3,1,aynmeow (我想成為安康魚),[問卦] 我朋友打雪仗害死同事,Wed Oct  7 21:14:56 2020
6,2,4,Mesenne (姆咪姆咪),[問卦] 店家數學不好的八卦？,Fri Oct  2 13:14:21 2020
1,1,0,chamge7788 (經濟王7887),[問卦] 湯底的四種，鄉民覺得哪個最好,Wed Oct  7 20:57:58 2020
0,0,0,zxc7 (OuO),[問卦] 千千跟lulu怎在比賽大胃王 卦,Fri Oct  2 15:39:37 2020
0,0,0,echoo (回聲O),[問卦] 澎湖的街景怎麼能那麼乾淨,Wed Oct  7 21:33:13 2020
19,2,17,jeff785chen (raincat29),[問卦] 到好市多有什麼必買的,Wed Oct  7 17:12:19 2020
12,2,10,TPDC (                 ),[新聞] 疑女友中秋夜跑去跟新歡烤肉 醋男尾隨撂,Fri Oct  2 12:12:57 2020
1,1,0,kone33221 (阿揪),[問卦] 有沒有長大就不挑食的八卦,Wed Oct  7 19:15:06 2020
7,0,7,colorless (colorless),[新聞] 諾貝爾化學獎 2名女學者研究基因編輯共享殊榮,Wed Oct  7 17:58:04 2020
4,0,4,RachelMcAdam (瑞秋賣燈絲),[問卦] 鐵板紅藍州的美國選民在想什麼？,Wed Oct  7 18:11:36 2020
1,0,1,Gorbachev (戈巴契夫頭髮最長!),[問卦] 不管我的靈魂 困在哪個肉身...,Wed Oct  7 18:03:33 2020
24,4,20,k90209 (k90209),[問卦] 南部這樣的內容物 110合理嗎？,Wed Oct  7 19:48:53 2020
16,2,14,Government (政府),[問卦] 新娘來敬酒 拉住我衣袖又放開讓我走 怎辦,Fri Oct  2 11:39:28 2020
61,26,35,yank0612 (魯宅),[爆卦] 支那垃圾賤畜集體高潮,Fri Oct  2 14:10:22 2020
14,5,9,frogcty (小蛙),[問卦] 內湖區的東湖大停電，能幹嘛,Wed Oct  7 19:13:47 2020
4,2,2,wang19980531 (中立評論員),[問卦] 在台灣活得這麼爽 台灣哪可能輸出？,Wed Oct  7 18:08:03 2020
8,3,5,songgood (ilovegoodgame),[新聞] 違規左轉害死重機大學生情侶檔 預拌水泥,Wed Oct  7 18:20:30 2020
23,5,18,saiulbb (#KEEP MLB GREAT!),[問卦] 露營初新手從哪開始起步比較好的八卦阿？,Wed Oct  7 20:29:12 2020
1,0,1,tatty5566 ( ),[問卦] 有沒有拉姆齊Ramsay的八卦,Fri Oct  2 11:55:11 2020
1,2,-1,KahoJyumonji (Kahojyumonji),[新聞] 平林社區性平小旅行 帶動疫情後雙溪觀光,Wed Oct  7 20:41:07 2020
3,1,2,ntpuisbest (阿龍),[問卦] 每個診所醫生都台大主治的八卦,Fri Oct  2 13:21:36 2020
19,0,19,iamshana (CANINE力集中在一些重要S),[新聞] 「深入敵營」你儂我儂親密互動 林俊憲親,Fri Oct  2 14:14:41 2020
11,2,9,godgan (大俠巴西龜),[問卦] 有沒有哆啦a夢在武肺期間還破紀錄的八卦,Wed Oct  7 16:56:10 2020
14,2,12,GGINDOWBOW (吃肥肥裝頹頹),[問卦] 蛋黃酥是不是月餅中的經典？,Fri Oct  2 12:20:45 2020
76,4,72,ok8752665 ()()()()()()()()()()()(),[問卦] 川普死掉會怎樣,Fri Oct  2 13:15:19 2020
6,0,6,linhsiuwei (清心寡慾的天煞孤星),[問卦] 感覺行為沉淪了怎麼辦,Fri Oct  2 12:13:50 2020
4,1,3,Starcraft3 (小藥丸),[新聞] 又出包!實名制口罩僅2層沒有熔噴不織布,Wed Oct  7 21:10:09 2020
14,1,13,brokenback3 (3),[問卦] 川普第一次參加選舉就能當選美國總統？,Fri Oct  2 11:25:50 2020
19,2,17,andy199113 (Andy),[新聞] 男拾獲疑「龍涎香」石頭 鑑定結果出爐「,Wed Oct  7 21:10:34 2020
6,3,3,sowbox (sowbox),[問卦] 家裡跑出野生螃蟹怎麼辦,Wed Oct  7 19:20:08 2020
0,0,0,GeraldLiu (wolver),[問卦] 連罵人的嘴型也要馬賽克了嗎？,Fri Oct  2 13:33:54 2020
3,0,3,KENDO777 (KENDO777),[問卦] 病毒戰有多可怕,Fri Oct  2 13:18:54 2020
46,2,44,ak47box (陽光黃金蛋),[新聞] 高市國小冷氣跳電停機1個月！網讚柯文哲,Wed Oct  7 21:06:33 2020
23,0,23,kimi102240 (kiwibaby),[協尋] 瑞光路一段 民生東路 行車記錄器,Mon Sep 28 19:17:18 2020
6,2,4,voohong (SE Asia Fat Nerd),[問卦] 同事出去烤肉你自己留下來吃肯德基,Fri Oct  2 13:11:32 2020
4,3,1,fawangching (陽光宅叔),[問卦] 退伍超過八年到底會不會被教召？,Wed Oct  7 19:14:19 2020
2,4,-2,s37166117 (ace),[問卦] 嘴唇乾裂怎麼辦,Wed Oct  7 21:05:30 2020
6,1,5,Toyosushij (Toyosushij),[新聞] 「今晚我想來點....」毒蟲異想天開 竟偽,Fri Oct  2 12:01:48 2020
9,3,6,semna (11),[問卦] 台灣人一輩子要看幾遍食神？,Fri Oct  2 15:06:48 2020
42,5,37,kimura0701 (一天要喝3千cc的水),[問卦] 田壘居然還是現役選手？,Wed Oct  7 16:17:49 2020
2,0,2,zoocouple (stillstriving),[問卦] 有沒有彭恰恰個人債務問題的八卦,Wed Oct  7 17:46:29 2020
11,3,8,TZUYIC (Celine-Flying On My Own),[新聞] 何志偉綠中常會提美豬總量管制 莊瑞雄：,Wed Oct  7 20:26:18 2020
3,2,1,chen0625 (不知道要打什麼？),[問卦] 中國現在在想什麼？,Fri Oct  2 13:44:14 2020
1,7,-6,Rimi5566 (布口以欺付里美),[問卦] 101國慶日出生要取什麼名字,Fri Oct  2 12:01:43 2020
26,3,23,skycolor2 (dantuy),[問卦] 志玲姐姐說的雙節合一是哪雙節？,Fri Oct  2 11:27:53 2020
7,3,4,Darvish903 (頭髮捲慘了),[問卦] 為什麼8+9的女人都這麼瘦啊？,Fri Oct  2 15:26:33 2020
3,6,-3,cake10414 (Peter),[新聞] 台南黃金海岸淪垃圾海岸　中國媒體諷：這,Wed Oct  7 21:18:40 2020
47,3,44,ll6a (老成a~),[問卦] 川普打悲情牌會有人買單嗎？,Fri Oct  2 14:34:22 2020
10,3,7,hello456 (好無聊......),[新聞] 「天然木瓜牛奶」論壇約壞 一伸手下秒慘,Fri Oct  2 13:05:09 2020
62,0,62,HappyDiD (開心的動一動),[問卦] 日本章魚燒好吃嗎？,Wed Oct  7 16:58:36 2020
4,4,0,Soodesu (才不給你進勒 甲塞),[問卦] youbike 分不同齒數可行嗎,Wed Oct  7 19:06:22 2020
6,1,5,pl132 (pl132),[新聞]四方安全對話 印度自信滿滿：空軍已經隨,Wed Oct  7 21:10:35 2020
3,1,2,s10130804 (老摳摳一枚),[問卦] 很多人喜歡在火車或高鐵借網路？,Wed Oct  7 20:48:13 2020
7,4,3,DFIGHT (Dknight),[問卦] 要怎麼和自尊心強到不認錯的三寶溝通？,Fri Oct  2 11:59:16 2020
4,2,2,oftisa (oo),[問卦] 川普挺台應該幫台灣收購 FIAT-克萊斯勒,Fri Oct  2 14:06:25 2020
13,6,7,febula (febula),[問卦] 如果戰爭的話，你（個人）會投降嗎？,Wed Oct  7 19:37:49 2020
2,2,0,Holmes7 (El Mundo),[問卦] 教主有抽到魔關羽了嗎？,Fri Oct  2 14:33:26 2020
14,1,13,Laizinho (森野熊三),[爆卦] 拜登1991年時稱2020時我極可能已死了,Fri Oct  2 15:30:56 2020
1,0,1,didi0909 (asabulu),[問卦] 可以一人一信到白宮建議我川嗎？,Fri Oct  2 14:03:54 2020
2,3,-1,NoobCV (挑戦者+3),[問卦] 在711吃飯開直播的網美,Wed Oct  7 19:32:28 2020
7,1,6,Howard61313 (好餓),[問卦] 美國大選辯論，主持人華勒斯現在在想啥,Fri Oct  2 13:35:50 2020
14,1,13,start9963 (失火啦火葬場啦),[問卦] 被漆彈打到是有多痛啊,Fri Oct  2 13:03:10 2020
6,0,6,b10485762000 (台北寂寞部屋),[新聞] 火星真有生命存在？ 義大利科學家宣稱火,Fri Oct  2 11:38:57 2020
6,4,2,andy15053 (andy),[問卦] 月老這麼靈，各位肥宅怎麼還單身？,Fri Oct  2 11:37:16 2020
5,0,5,thesonofevil (四非亞心),[問卦] 老大 口水戰真的有用耶,Fri Oct  2 13:19:40 2020
7,5,2,qwer1988 (白獅),[問卦] 為何共匪軍機擾台 我們要出動驅逐？,Wed Oct  7 18:30:15 2020
6,0,6,asdfg012345 (Vicious circle),[問卦] 美國不開戰！總統總統染疫難道吞下去,Fri Oct  2 14:41:51 2020
9,2,7,cdcardabc (覺得難笑就給個推去逃漏5),[問卦] 川普中標 五毛高潮？,Fri Oct  2 14:58:21 2020
37,3,34,qazxc1156892 (QQ),[新聞] 川普拒絕「改變辯論形式」：我上次輕鬆,Fri Oct  2 11:45:34 2020
3,0,3,ljsnonocat2 (凡所有相皆是虛妄),[問卦] 共機擾台 可以用雷達鎖定嗎？,Wed Oct  7 19:10:39 2020
9,1,8,GGBronze (DavidWang),[問卦] 認真問 準備電機研究所大概要多久？？,Fri Oct  2 15:02:54 2020
10,2,8,ilc0217 (老羽),[爆卦] 中秋夜，我家門口有人自撞,Fri Oct  2 13:23:21 2020
3,3,0,philip5566 (5566得第一),[爆卦] 台灣上華盛頓郵報…的標題,Wed Oct  7 20:07:24 2020
1,9,-8,Bape5566APE (我的迷彩外套有5個仁甫頭),[問卦] 愛莉莎莎刻在你心底的名字,Fri Oct  2 12:39:29 2020
10,1,9,taco3019397 (taco),[問卦] 月收50萬在鄉下是什麼等級,Fri Oct  2 15:31:37 2020
5,4,1,kinki999 (QQk 廢文被劣文中),[問卦] 台女脫口秀只能靠黃色出名嗎,Fri Oct  2 12:54:29 2020
8,0,8,gogopacer (gogopacer),[問卦] 憑實力發爆文是不是滿強的？,Wed Oct  7 19:36:29 2020
48,19,29,admeta (陽明山),[新聞] 佛心來的！全台唯一「特斯拉小黃」在新竹,Wed Oct  7 16:44:39 2020
3,9,-6,norvasc (Norton),[問卦] 愛莉莎莎居然還沒男友？ 怎麼解釋,Fri Oct  2 12:07:11 2020
3,0,3,zarados (HowKung-Fu),[問卦] 美軍 CIA 現在在幹嘛？,Fri Oct  2 14:00:28 2020
3,0,3,scotch77642 (夢遺張孝全),[問卦] 女生會愛看軍教片嗎,Fri Oct  2 13:32:49 2020
23,0,23,muse87131 (),[問卦] 川普中標，週一台股怎麼玩？,Fri Oct  2 13:41:36 2020
31,5,26,Tencc (10cc),[新聞] 深夜驚魂！妙齡女遭尾隨200米　急叩男友,Wed Oct  7 18:42:56 2020
44,2,42,Busufu (不太舒服),[問卦] 工程師該開什麼等級的車？,Wed Oct  7 18:04:45 2020
8,4,4,leon105 (@@),[新聞] 背女友偷吃同校妹「6天做3次」！專科男,Wed Oct  7 20:22:45 2020
7,0,7,melissalewis (龍使弗利茲),[問卦] ‘’和平‘’是不是根本不可能？,Fri Oct  2 12:36:51 2020
4,3,1,xxxluke (我手裡拿著小皮鞭),[問卦] 鳴人共使出多少次影分身？,Wed Oct  7 19:58:41 2020
234,36,198,GrimmNotes (格林童話),[問卦] 中國人：川普一死 下個就換台灣,Fri Oct  2 13:50:44 2020
2,3,-1,ergostepo (ergo),[問卦] 大家國慶連假有出遊嗎？,Fri Oct  2 11:53:17 2020
5,6,-1,staedtler (鐵甲武士),[新聞] 色男持刀白嫖強盜按摩女　留100元給她吃,Fri Oct  2 13:48:51 2020
13,6,7,waymayday (不要問),[問卦] 貓貓要怎麼料理？,Wed Oct  7 20:15:14 2020
9,3,6,HisVol (他的體積),[問卦] 台灣自行車廠為什麼比汽車強那麼多？,Fri Oct  2 12:23:57 2020
19,1,18,KouKouMeow (摳摳),[協尋] 高雄前金區 黑白貓小蜜(代po),Wed Sep 30 22:46:26 2020
6,2,4,ilovemami (聯絡簿教主),[問卦] 能免役要免役嗎,Wed Oct  7 17:53:33 2020
0,0,0,GOD5566GOD (o'_'o),[新聞] 川普夫婦確診 羅友志驚喊：美國版的兩顆,Fri Oct  2 15:44:00 2020
7,2,5,billkingFH (kiraqueen),[問卦] 絕版的書自行列印會觸法嗎？,Fri Oct  2 13:57:57 2020
2,0,2,Acalanatha (不動明王),[問卦] 中國人的傳統美德都到哪兒去了？,Fri Oct  2 12:09:10 2020
4,0,4,smalltwo (獎金獵人),[新聞] 水情拉警報 桃竹苗台中4區域下週三起實施,Wed Oct  7 17:43:30 2020
59,15,44,Aruka0924 (Aruka),[問卦] 台灣豬標章得獎作者：綠色代表安全,Wed Oct  7 19:42:09 2020
16,5,11,lunli924 (餛飩),[問卦] hebe的唱腔 怎麼越來越奇怪,Wed Oct  7 17:25:23 2020
0,0,0,TomRiddle (湯姆瑞斗),[問卦] 現實世界要怎麼拐走有錢人的未婚妻,Fri Oct  2 13:38:52 2020
5,1,4,sinana (  ),[問卦] 裝病,Fri Oct  2 13:49:48 2020
111,2,109,TyuzuChou (子瑜我老婆),[新聞] 川普確診新冠肺炎 感染科醫：拜登危險了,Fri Oct  2 14:03:56 2020
10,6,4,yorkyoung (約克羊),[問卦] 每次睡醒頭髮都會亂翹怎麼辦,Fri Oct  2 12:18:41 2020
2,2,0,teeheehee (軟尾拋拋翔(′・ω・`)),[問卦] 中秋烤肉趴帶甚麼食材最雷？,Fri Oct  2 12:57:57 2020
23,0,23,kiball (stay hungry),[新聞] 「反覆自打臉又一直要當官」　林為洲再,Wed Oct  7 17:44:20 2020
88,2,86,JetChen (JetChen),[問卦] 如果川普康復會說什麼？,Fri Oct  2 13:51:37 2020
11,0,11,chuchichan (老邱),[問卦] 北市新生南路是不是設計得很智障,Fri Oct  2 12:59:45 2020
15,1,14,jackymars5 ((                )),[問卦] 有無秋天真的來臨了,Wed Oct  7 19:20:53 2020
4,1,3,Cassander (Cassander),[新聞]瑞郎升不停 瑞士央行擋不住,Wed Oct  7 19:14:37 2020
4,1,3,sploo (正確的方向決定一切),[問卦] 歐陽娜娜是不是用來轉移焦點的,Fri Oct  2 11:58:53 2020
3,7,-4,ckp4131025 (ckp4131025),[問卦] Buffett 只吃8分飽算財富自由嗎,Fri Oct  2 12:40:05 2020
17,1,16,Thirdshadow (滑蛋少年糰),[問卦] 如何入門二戰歷史？,Fri Oct  2 15:17:49 2020
1,3,-2,Gary5566 (等我長大要娶天音かなた),[問卦] 下課想直接回家卻被我姊叫去加社團,Wed Oct  7 21:17:44 2020
85,26,59,AZ09 (卡薩丁守中路),[新聞] 五星旗亂象》防中共藉言論自由統戰 綠委,Fri Oct  2 12:15:07 2020
19,5,14,seabox (盒盒),[公告] 數條板規修改草案於gossippicket討論,Sun Oct  4 21:16:27 2020
2,3,-1,david0426 (軒軒寶貝),[問卦] 吃螃蟹時都怎麼去殼？,Wed Oct  7 19:53:39 2020
5,0,5,edwardsyo (愛德華),[問卦] 川普康復後會說什麼,Fri Oct  2 14:46:38 2020
128,7,121,hateOnas (老伴 △要怕老婆),[問卦] 清國國慶是何時？發錢算內亂嗎,Fri Oct  2 12:47:05 2020
9,4,5,love913109 (暖男好難當),[問卦] 買3杯綠豆沙牛奶只有一根吸管是什麼意思,Wed Oct  7 16:38:12 2020
124,13,111,tony900735 (安西街教練),[問卦] 拜登超穩了吧？,Fri Oct  2 13:29:49 2020
19,4,15,googolplex (googolplex),[新聞] 扁籲朝野兩岸和解 馬點頭相挺,Fri Oct  2 12:49:51 2020
89,7,82,shenguan (申申不息),[問卦] 陸客多久沒來了台灣也沒怎樣,Wed Oct  7 18:10:15 2020
17,3,14,mossdevin (Devin Moss 10),[問卦] 中國戰狼外交成果出爐! 全世界恨死了!,Wed Oct  7 19:10:59 2020
11,4,7,taipei5566 (臺北56),[問卦] 多賢最可愛是什麼時期？,Fri Oct  2 14:20:04 2020
18,4,14,HisVol (他的體積),[新聞] 獨家｜金曲台語歌后浴室全裸重摔　送急診,Wed Oct  7 16:30:37 2020
6,0,6,Scathach (紫色BBA),[問卦] 維尼的歷史定位是不是穩了,Fri Oct  2 13:10:10 2020
8,1,7,marsalien (mars),[問卦] 民主黨派拜登是不是看美國人沒有,Fri Oct  2 12:50:03 2020
13,7,6,joliha (一輪明月),[問卦] 盲眼神婆巴巴萬加預言川普罹怪病倒下,Fri Oct  2 15:09:38 2020
4,1,3,jeremytsai (鬆),[問卦] 煞車油缸維修要多少錢啊？,Wed Oct  7 17:28:34 2020
1,2,-1,neil136 (BianYuanFeiJhai),[問卦] 賣炸雞的，怎麼都不見了？,Fri Oct  2 15:19:24 2020
6,1,5,WuDunE (GLAUCUS),[問卦] 台灣能養老虎嗎,Wed Oct  7 18:26:11 2020
5,1,4,createlight (創輝),[新聞] 中共「抄近道」求世衛幫推未完成試驗的疫,Wed Oct  7 20:59:47 2020
5,2,3,americ (americ),[問卦] 有沒有7分鐘就一篇大紀元新唐人的八卦,Wed Oct  7 20:49:23 2020
6,3,3,smileboy2016 (Sand Tree Pad),[問卦] 慟！愛樂電台電腦版全面收費了！！！,Wed Oct  7 17:36:03 2020
16,0,16,girl55665566 (同志友善ID),[新聞] 宣稱保護同志導致滅亡 日本東京區議員拒,Wed Oct  7 20:04:28 2020
33,4,29,nobel777 (),[爆卦] 王柏融棒打日本澤村賞名投,Wed Oct  7 19:19:13 2020
2,2,0,fly820822 (大飛哥啦),[問卦] 美國484房子都可以隨便蓋,Fri Oct  2 14:26:46 2020
10,4,6,toolmaster (工具人大師),[問卦] 在北極丟冰塊就好了吧？,Fri Oct  2 11:49:37 2020
34,1,33,Ryo5566 (),[新聞] 酒店公關爽吃人夫...還跩嗆正宮「鬆姐黑,Fri Oct  2 14:47:34 2020
4,1,3,createlight (創輝),[新聞] 美50參議員促啓動美台全面貿易協議談判,Fri Oct  2 12:55:21 2020
6,1,5,kbt2720 (master),[問卦] 印加果油的卦,Wed Oct  7 16:44:08 2020
24,2,22,wei0204 (喂~色情電話),[新聞] 3葬槍道別！孫女捧骨灰 李登輝長眠五指山,Wed Oct  7 20:31:24 2020
3,1,2,LeeAnAn (就值得了愛，就值得了等),[問卦] 強人為什麼都先有女兒？,Wed Oct  7 17:41:56 2020
1,0,1,Yirgacheffe (守住善良),[新聞] 美公布年度難民接納計劃 首次納入香港人,Fri Oct  2 13:26:58 2020
12,2,10,Elsie1999 (艾兒),[問卦] 為何大腸麵線要加蒜泥？？,Wed Oct  7 18:33:43 2020
5,10,-5,t77133562003 (我是一隻山羊),[新聞] 蘇揆指示 儘速盤整資安黑名單,Wed Oct  7 17:02:51 2020
1,1,0,ann141414 (海底撈火鍋),[問卦] 川普是不是要下去了啊,Fri Oct  2 13:24:34 2020
8,1,7,nail5566 (寶寶不說),[問卦] 川普推特1小時20萬留言,Fri Oct  2 14:32:40 2020
12,1,11,saiulbb (#KEEP MLB GREAT!),[新聞] 「你幾歲開始長陰毛？」 丹麥兒童節目給,Wed Oct  7 21:21:10 2020
2,0,2,yogurt0313 (愛草莓),[問卦] 銀行一直打來幹嘛,Wed Oct  7 18:43:14 2020
10,3,7,ginsengwolf ( ),[問卦] 梅花三不能保留是不是多數暴力,Wed Oct  7 16:13:59 2020
3,2,1,zakijudelo (Zack),[問卦] 共軍會不等外國人撤僑就打台灣？,Wed Oct  7 17:54:26 2020
4,10,-6,alinalovers (凜冬將至企鵝在天涯),"[問卦] Baby shark, doo, doo, doo, doo, doo,",Wed Oct  7 20:00:41 2020
11,0,11,utdsml (阿邊肥),[問卦] 推薦台中不會瘋狂推銷的健身房,Fri Oct  2 12:01:30 2020
4,0,4,farmer (^_^),[問卦] 房地產會崩盤嗎？,Fri Oct  2 14:59:42 2020
12,1,11,yoyo2008yoyo (Jgosu?),[問卦] 玩什麼遊戲才不顯宅啊,Fri Oct  2 12:30:29 2020
4,4,0,juyhnmki (juyhnmki),[問卦] 光頭櫻木來了！！,Fri Oct  2 13:19:10 2020
2,1,1,h50212263 (奈威),[問卦] 很用力業配奮game有多辛苦？,Fri Oct  2 15:13:00 2020
4,0,4,iamshana (CANINE力集中在一些重要S),[新聞] 台鐵區間車撞到闖入機車 保安=中洲雙向,Wed Oct  7 21:17:49 2020
2,2,0,Comebuy (三分鐘熱度),[新聞] 違國際禁令偷賣北韓石油3000噸　貪財船東,Wed Oct  7 21:16:21 2020
47,12,35,Anddyliu (安滴滴),[新聞] 教召不夠！陳玉珍提「金門民防自衛隊」,Wed Oct  7 16:57:21 2020
3,2,1,coon182 (微笑小空空♥),[問卦] 有沒有全聯要開節目的八卦,Wed Oct  7 20:26:42 2020
8,0,8,ben28 (ben),[問卦] 川普這次不死也半殘了？,Fri Oct  2 13:25:46 2020
3,2,1,wsp0323 (wsp0323),[問卦] 愛Z莎莎跟那兩個日本人到底有沒外流影片,Fri Oct  2 11:55:51 2020
20,18,2,hbk20491 (〥夢中情一場夢〥),[新聞] 陳廷寵「國軍戰力零」論 吳斯懷：憲法言,Wed Oct  7 16:37:51 2020
1,0,1,nicolaskage (棋聖),[問卦] 我們是不是都把藝人想錯了,Fri Oct  2 12:55:31 2020
10,1,9,AllMight (澤近愛理我老婆),[問卦] 白石到底有什麼資格站在西野七瀬旁邊？,Wed Oct  7 21:07:42 2020
8,2,6,ans781020 (5566),[問卦]急！ 台中一中街有沒有能寄放包包的,Fri Oct  2 12:23:36 2020
6,3,3,toto3527 (toto),[問卦] 我破解兩岸開戰的方法了,Wed Oct  7 21:03:07 2020
4,2,2,a09651238 (可口美味好滋味),[問卦] 台股來不及逃耶,Fri Oct  2 13:27:12 2020
48,3,45,kailayxiudo (肉毒桿菌),"[新聞] Excel漏數據之亂 英國1萬6,000名COVID-19",Wed Oct  7 19:23:10 2020
48,6,42,LinuxKernel (Linus Torvalds),[新聞] 綠委竟爆陳其邁上任後 高雄治安不佳 懲處,Wed Oct  7 19:59:05 2020
2,0,2,johanLarson (Rent),[問卦] 中國開始要抹臭美國了嗎,Fri Oct  2 13:39:04 2020
15,1,14,rosefan (Rocket Queen),[新聞] 川普確診｜重大！川普證實和第一夫人確,Fri Oct  2 13:42:57 2020
10,3,7,gn01914712 (台大人類系之光柏豪哥),[問卦] 隨便說三個台北市景點,Wed Oct  7 16:48:47 2020
8,2,6,bornwinner (tripleandyliu),[問卦] 拜登如果也確診美國大選會延期嗎？,Fri Oct  2 15:15:59 2020
0,0,0,seabox (盒盒),[公告] 八卦板板規(2020.07.21),Tue Jul 21 00:00:04 2020
22,35,-13,armorblocks (package),[新聞] 新課本撞臉小英 蔡英文笑：以後都要選女,Wed Oct  7 19:03:27 2020
1,3,-2,kopuck (派翠克星星),[問卦] 白鞋為什麼這麼誘人,Fri Oct  2 11:57:31 2020
0,0,0,JimOBrien (family man),[新聞] 屏東新住民媽媽搭起溝通橋樑 影像記錄移,Fri Oct  2 12:55:10 2020
4,1,3,eeth (韓國綜藝社),[新聞] 新澤西州垃圾箱內發現成堆郵件 包括選票,Wed Oct  7 20:28:58 2020
42,4,38,v26457681 (),[問卦] 義交都是計程車司機兼差 時薪300,Wed Oct  7 17:21:35 2020
13,12,1,blueskymaple (你是不是在發球),[新聞] 他選上高雄拋棄年輕人？李眉蓁怒：這錢,Wed Oct  7 19:25:11 2020
2,5,-3,Fortran (Fortran),[問卦] 墾丁後壁湖海底十字架的八卦,Wed Oct  7 21:23:52 2020
2,0,2,cycling (一直暴雷一直爽),[新聞] 在野3黨明聯合提監院人事案釋憲　藍白合,Wed Oct  7 20:53:11 2020
2,4,-2,AllBlack (All Black),[問卦] 支持英國、美國即刻進攻中國！,Fri Oct  2 13:32:10 2020
12,4,8,lescafe (),[新聞] 有片／人在美國不忘花蓮　蕭美琴錄影捎,Fri Oct  2 12:34:35 2020
19,0,19,seibu (難過),[新聞] 操作吊車誤觸高壓電 男子遭電擊送醫,Wed Oct  7 16:32:10 2020
1,1,0,JasperChang (PeterChou),[問卦] 暗槓退房小費有搞頭嗎,Wed Oct  7 20:57:34 2020
5,1,4,paulabxz123 (優文大師),[問卦] 手機的emoji表情符號484很嘲諷,Fri Oct  2 12:55:06 2020
3,1,2,layu19920414 (Guan-Jie Huang),[問卦] 萬華的廚具店484很黑牙？,Wed Oct  7 20:06:20 2020
7,2,5,chadmu (查德姆),[問卦] 在全聯上班是什麼感覺,Wed Oct  7 21:21:50 2020
60,2,58,pitalvlu (pital),[新聞] 川普確診「躺棺材」曝光！美網友貼辛普,Fri Oct  2 14:18:21 2020
29,6,23,whj0530 (億載金城武),[新聞] 川普夫婦確診陸網嗨爆！直衝微博熱搜第一,Fri Oct  2 14:59:13 2020
3,0,3,Giddcns (狠、插、勁！！！),[問卦] 命理老師會怎麼評論這波染疫？,Fri Oct  2 13:47:19 2020
28,2,26,hoyumi (正版型男...無誤!!!),[新聞] 立院初審 調戲同性最高可處6000元罰鍰,Wed Oct  7 17:29:05 2020
167,8,159,CharleneTsai (給他200塊去吃麥當勞啦),[新聞] 海邊漂來「怪香黑石」！送檢報告出爐「就,Wed Oct  7 16:48:39 2020
2,4,-2,Dinenger (低能兒),[問卦] 欸欸 川普甘我屁事？洗一堆標題,Fri Oct  2 13:36:11 2020
3,2,1,pewdiefish (PewDieFish),[問卦] 有沒有胸罩L75是什麼概念的八卦,Wed Oct  7 18:25:38 2020
6,0,6,tatty5566 ( ),[問卦] 當時屯酒精的現在在想什麼,Fri Oct  2 13:33:29 2020
7,1,6,wavespirit (鄉民進化論),[新聞] 川普染疫！新冠病毒檢測呈陽性 道瓊期指4,Fri Oct  2 13:41:55 2020
1,1,0,zakijudelo (Zack),[問卦] 川普辯論會狂插話噴口水，是計畫通？,Fri Oct  2 13:30:08 2020
1,0,1,seth5421 (正版廢文王),[問卦] 大家會仔細算找回來的錢嗎,Wed Oct  7 20:52:07 2020
22,29,-7,Israfil (贖罪聖音),[新聞] 中共不是祖國？蔡正元歷史分析 「中國確,Fri Oct  2 15:10:13 2020
6,3,3,ToHsiang (誤上賊船),[新聞] 2北市長熱門人選同現身 陳時中讚不簡單林右,Fri Oct  2 15:24:08 2020
63,21,42,joug (好東西不簽嗎),[新聞] 國防部：教召14天最高加薪1.5倍　1年1訓2,Wed Oct  7 16:31:29 2020
6,1,5,thegreatlcx (體制就跟五樓屁股一樣),[問卦] 台灣工人的形象怎麼救？,Fri Oct  2 14:32:48 2020
4,2,2,elec1141 (木村拓哉),[問卦] 川普中鏢 算中國攻擊嗎？,Fri Oct  2 13:27:56 2020
2,5,-3,qskingq (勾勾),[問卦] 如果美國堅持一中原則，台灣會被扁嗎==,Fri Oct  2 14:18:48 2020
7,1,6,MintSu (Simon),[問卦] 中國功夫打的贏印度少林功夫嗎？,Wed Oct  7 16:42:58 2020
9,2,7,ben28 (ben),[問卦] 賀中共國慶的藝人會賀我們國慶嗎？,Fri Oct  2 11:46:43 2020
5,0,5,doraBBO (天才小釣手),[問卦] 為什麼要相信房子會跌不能買這種話？,Wed Oct  7 19:37:00 2020
7,0,7,nothisman (在人海中迷失),[新聞] 地表「最胖肥熊」出爐！　635kg棕熊挺「,Wed Oct  7 21:00:58 2020
0,0,0,wa778895 (oilsunbright),[問卦] 我是被下套了嗎？,Wed Oct  7 21:27:26 2020
15,4,11,stan0720 (Kimo),[問卦] 認真問 人一天可以走幾公里呀？,Fri Oct  2 14:00:50 2020
5,0,5,bigtreelife (Tree),[問卦] 叫外送的年輕人都是什麼人,Fri Oct  2 15:29:44 2020
